,idx,pop_num,pop_cum_num,ID_num_0.68,ID_cum_num_0.68,ID_cum_rate_0.68,ID_rate_0.68,ID_num_0.9,ID_cum_num_0.9,ID_cum_rate_0.9,ID_rate_0.9,ID_num_0.95,ID_cum_num_0.95,ID_cum_rate_0.95,ID_rate_0.95,ID_num_0.99,ID_cum_num_0.99,ID_cum_rate_0.99,ID_rate_0.99,ID_num_0.999,ID_cum_num_0.999,ID_cum_rate_0.999,ID_rate_0.999,ID_num_0.9999,ID_cum_num_0.9999,ID_cum_rate_0.9999,ID_rate_0.9999,ID_num_0.99999,ID_cum_num_0.99999,ID_cum_rate_0.99999,ID_rate_0.99999
0,1,4,4,3,3,0.75,0.75,4,4,1.0,1.0,4,4,1.0,1.0,4,4,1.0,1.0,4,4,1.0,1.0,4,4,1.0,1.0,4,4,1.0,1.0
1,3,1,5,1,4,0.8,1.0,1,5,1.0,1.0,1,5,1.0,1.0,1,5,1.0,1.0,1,5,1.0,1.0,1,5,1.0,1.0,1,5,1.0,1.0
2,4,1,6,0,4,0.667,0.0,1,6,1.0,1.0,1,6,1.0,1.0,1,6,1.0,1.0,1,6,1.0,1.0,1,6,1.0,1.0,1,6,1.0,1.0
3,5,2,8,2,6,0.75,1.0,2,8,1.0,1.0,2,8,1.0,1.0,2,8,1.0,1.0,2,8,1.0,1.0,2,8,1.0,1.0,2,8,1.0,1.0
4,6,2,10,2,8,0.8,1.0,2,10,1.0,1.0,2,10,1.0,1.0,2,10,1.0,1.0,2,10,1.0,1.0,2,10,1.0,1.0,2,10,1.0,1.0
5,7,1,11,1,9,0.818,1.0,1,11,1.0,1.0,1,11,1.0,1.0,1,11,1.0,1.0,1,11,1.0,1.0,1,11,1.0,1.0,1,11,1.0,1.0
6,8,1,12,0,9,0.75,0.0,1,12,1.0,1.0,1,12,1.0,1.0,1,12,1.0,1.0,1,12,1.0,1.0,1,12,1.0,1.0,1,12,1.0,1.0
7,11,2,14,1,10,0.714,0.5,1,13,0.929,0.5,1,13,0.929,0.5,1,13,0.929,0.5,2,14,1.0,1.0,2,14,1.0,1.0,2,14,1.0,1.0
8,12,2,16,1,11,0.688,0.5,2,15,0.938,1.0,2,15,0.938,1.0,2,15,0.938,1.0,2,16,1.0,1.0,2,16,1.0,1.0,2,16,1.0,1.0
9,15,1,17,0,11,0.647,0.0,0,15,0.882,0.0,0,15,0.882,0.0,0,15,0.882,0.0,1,17,1.0,1.0,1,17,1.0,1.0,1,17,1.0,1.0
10,16,1,18,1,12,0.667,1.0,1,16,0.889,1.0,1,16,0.889,1.0,1,16,0.889,1.0,1,18,1.0,1.0,1,18,1.0,1.0,1,18,1.0,1.0
11,18,1,19,1,13,0.684,1.0,1,17,0.895,1.0,1,17,0.895,1.0,1,17,0.895,1.0,1,19,1.0,1.0,1,19,1.0,1.0,1,19,1.0,1.0
12,19,1,20,0,13,0.65,0.0,1,18,0.9,1.0,1,18,0.9,1.0,1,18,0.9,1.0,1,20,1.0,1.0,1,20,1.0,1.0,1,20,1.0,1.0
13,20,1,21,1,14,0.667,1.0,1,19,0.905,1.0,1,19,0.905,1.0,1,19,0.905,1.0,1,21,1.0,1.0,1,21,1.0,1.0,1,21,1.0,1.0
14,21,1,22,0,14,0.636,0.0,1,20,0.909,1.0,1,20,0.909,1.0,1,20,0.909,1.0,1,22,1.0,1.0,1,22,1.0,1.0,1,22,1.0,1.0
15,22,1,23,1,15,0.652,1.0,1,21,0.913,1.0,1,21,0.913,1.0,1,21,0.913,1.0,1,23,1.0,1.0,1,23,1.0,1.0,1,23,1.0,1.0
16,24,1,24,1,16,0.667,1.0,1,22,0.917,1.0,1,22,0.917,1.0,1,22,0.917,1.0,1,24,1.0,1.0,1,24,1.0,1.0,1,24,1.0,1.0
17,26,2,26,2,18,0.692,1.0,2,24,0.923,1.0,2,24,0.923,1.0,2,24,0.923,1.0,2,26,1.0,1.0,2,26,1.0,1.0,2,26,1.0,1.0
18,30,1,27,1,19,0.704,1.0,1,25,0.926,1.0,1,25,0.926,1.0,1,25,0.926,1.0,1,27,1.0,1.0,1,27,1.0,1.0,1,27,1.0,1.0
19,33,3,30,2,21,0.7,0.667,3,28,0.933,1.0,3,28,0.933,1.0,3,28,0.933,1.0,3,30,1.0,1.0,3,30,1.0,1.0,3,30,1.0,1.0
20,34,2,32,2,23,0.719,1.0,2,30,0.938,1.0,2,30,0.938,1.0,2,30,0.938,1.0,2,32,1.0,1.0,2,32,1.0,1.0,2,32,1.0,1.0
21,35,2,34,1,24,0.706,0.5,1,31,0.912,0.5,2,32,0.941,1.0,2,32,0.941,1.0,2,34,1.0,1.0,2,34,1.0,1.0,2,34,1.0,1.0
22,36,1,35,1,25,0.714,1.0,1,32,0.914,1.0,1,33,0.943,1.0,1,33,0.943,1.0,1,35,1.0,1.0,1,35,1.0,1.0,1,35,1.0,1.0
23,37,2,37,2,27,0.73,1.0,2,34,0.919,1.0,2,35,0.946,1.0,2,35,0.946,1.0,2,37,1.0,1.0,2,37,1.0,1.0,2,37,1.0,1.0
24,38,1,38,1,28,0.737,1.0,1,35,0.921,1.0,1,36,0.947,1.0,1,36,0.947,1.0,1,38,1.0,1.0,1,38,1.0,1.0,1,38,1.0,1.0
25,39,1,39,1,29,0.744,1.0,1,36,0.923,1.0,1,37,0.949,1.0,1,37,0.949,1.0,1,39,1.0,1.0,1,39,1.0,1.0,1,39,1.0,1.0
26,40,2,41,1,30,0.732,0.5,2,38,0.927,1.0,2,39,0.951,1.0,2,39,0.951,1.0,2,41,1.0,1.0,2,41,1.0,1.0,2,41,1.0,1.0
27,41,1,42,1,31,0.738,1.0,1,39,0.929,1.0,1,40,0.952,1.0,1,40,0.952,1.0,1,42,1.0,1.0,1,42,1.0,1.0,1,42,1.0,1.0
28,42,1,43,1,32,0.744,1.0,1,40,0.93,1.0,1,41,0.953,1.0,1,41,0.953,1.0,1,43,1.0,1.0,1,43,1.0,1.0,1,43,1.0,1.0
29,44,1,44,1,33,0.75,1.0,1,41,0.932,1.0,1,42,0.955,1.0,1,42,0.955,1.0,1,44,1.0,1.0,1,44,1.0,1.0,1,44,1.0,1.0
30,45,1,45,1,34,0.756,1.0,1,42,0.933,1.0,1,43,0.956,1.0,1,43,0.956,1.0,1,45,1.0,1.0,1,45,1.0,1.0,1,45,1.0,1.0
31,46,5,50,4,38,0.76,0.8,5,47,0.94,1.0,5,48,0.96,1.0,5,48,0.96,1.0,5,50,1.0,1.0,5,50,1.0,1.0,5,50,1.0,1.0
32,47,2,52,0,38,0.731,0.0,2,49,0.942,1.0,2,50,0.962,1.0,2,50,0.962,1.0,2,52,1.0,1.0,2,52,1.0,1.0,2,52,1.0,1.0
33,48,1,53,0,38,0.717,0.0,0,49,0.925,0.0,0,50,0.943,0.0,1,51,0.962,1.0,1,53,1.0,1.0,1,53,1.0,1.0,1,53,1.0,1.0
34,49,6,59,6,44,0.746,1.0,6,55,0.932,1.0,6,56,0.949,1.0,6,57,0.966,1.0,6,59,1.0,1.0,6,59,1.0,1.0,6,59,1.0,1.0
35,50,2,61,1,45,0.738,0.5,2,57,0.934,1.0,2,58,0.951,1.0,2,59,0.967,1.0,2,61,1.0,1.0,2,61,1.0,1.0,2,61,1.0,1.0
36,51,3,64,2,47,0.734,0.667,3,60,0.938,1.0,3,61,0.953,1.0,3,62,0.969,1.0,3,64,1.0,1.0,3,64,1.0,1.0,3,64,1.0,1.0
37,53,2,66,1,48,0.727,0.5,2,62,0.939,1.0,2,63,0.955,1.0,2,64,0.97,1.0,2,66,1.0,1.0,2,66,1.0,1.0,2,66,1.0,1.0
38,54,2,68,1,49,0.721,0.5,2,64,0.941,1.0,2,65,0.956,1.0,2,66,0.971,1.0,2,68,1.0,1.0,2,68,1.0,1.0,2,68,1.0,1.0
39,55,4,72,4,53,0.736,1.0,4,68,0.944,1.0,4,69,0.958,1.0,4,70,0.972,1.0,4,72,1.0,1.0,4,72,1.0,1.0,4,72,1.0,1.0
40,56,1,73,1,54,0.74,1.0,1,69,0.945,1.0,1,70,0.959,1.0,1,71,0.973,1.0,1,73,1.0,1.0,1,73,1.0,1.0,1,73,1.0,1.0
41,58,2,75,0,54,0.72,0.0,2,71,0.947,1.0,2,72,0.96,1.0,2,73,0.973,1.0,2,75,1.0,1.0,2,75,1.0,1.0,2,75,1.0,1.0
42,59,3,78,1,55,0.705,0.333,3,74,0.949,1.0,3,75,0.962,1.0,3,76,0.974,1.0,3,78,1.0,1.0,3,78,1.0,1.0,3,78,1.0,1.0
43,60,1,79,1,56,0.709,1.0,1,75,0.949,1.0,1,76,0.962,1.0,1,77,0.975,1.0,1,79,1.0,1.0,1,79,1.0,1.0,1,79,1.0,1.0
44,61,3,82,1,57,0.695,0.333,1,76,0.927,0.333,3,79,0.963,1.0,3,80,0.976,1.0,3,82,1.0,1.0,3,82,1.0,1.0,3,82,1.0,1.0
45,62,2,84,2,59,0.702,1.0,2,78,0.929,1.0,2,81,0.964,1.0,2,82,0.976,1.0,2,84,1.0,1.0,2,84,1.0,1.0,2,84,1.0,1.0
46,63,3,87,2,61,0.701,0.667,3,81,0.931,1.0,3,84,0.966,1.0,3,85,0.977,1.0,3,87,1.0,1.0,3,87,1.0,1.0,3,87,1.0,1.0
47,64,3,90,2,63,0.7,0.667,2,83,0.922,0.667,3,87,0.967,1.0,3,88,0.978,1.0,3,90,1.0,1.0,3,90,1.0,1.0,3,90,1.0,1.0
48,65,4,94,3,66,0.702,0.75,4,87,0.926,1.0,4,91,0.968,1.0,4,92,0.979,1.0,4,94,1.0,1.0,4,94,1.0,1.0,4,94,1.0,1.0
49,66,1,95,1,67,0.705,1.0,1,88,0.926,1.0,1,92,0.968,1.0,1,93,0.979,1.0,1,95,1.0,1.0,1,95,1.0,1.0,1,95,1.0,1.0
50,68,4,99,4,71,0.717,1.0,4,92,0.929,1.0,4,96,0.97,1.0,4,97,0.98,1.0,4,99,1.0,1.0,4,99,1.0,1.0,4,99,1.0,1.0
51,69,2,101,2,73,0.723,1.0,2,94,0.931,1.0,2,98,0.97,1.0,2,99,0.98,1.0,2,101,1.0,1.0,2,101,1.0,1.0,2,101,1.0,1.0
52,70,1,102,1,74,0.725,1.0,1,95,0.931,1.0,1,99,0.971,1.0,1,100,0.98,1.0,1,102,1.0,1.0,1,102,1.0,1.0,1,102,1.0,1.0
53,71,5,107,2,76,0.71,0.4,4,99,0.925,0.8,5,104,0.972,1.0,5,105,0.981,1.0,5,107,1.0,1.0,5,107,1.0,1.0,5,107,1.0,1.0
54,72,2,109,0,76,0.697,0.0,1,100,0.917,0.5,2,106,0.972,1.0,2,107,0.982,1.0,2,109,1.0,1.0,2,109,1.0,1.0,2,109,1.0,1.0
55,73,4,113,3,79,0.699,0.75,3,103,0.912,0.75,4,110,0.973,1.0,4,111,0.982,1.0,4,113,1.0,1.0,4,113,1.0,1.0,4,113,1.0,1.0
56,74,2,115,0,79,0.687,0.0,0,103,0.896,0.0,2,112,0.974,1.0,2,113,0.983,1.0,2,115,1.0,1.0,2,115,1.0,1.0,2,115,1.0,1.0
57,75,3,118,0,79,0.669,0.0,3,106,0.898,1.0,3,115,0.975,1.0,3,116,0.983,1.0,3,118,1.0,1.0,3,118,1.0,1.0,3,118,1.0,1.0
58,76,2,120,0,79,0.658,0.0,2,108,0.9,1.0,2,117,0.975,1.0,2,118,0.983,1.0,2,120,1.0,1.0,2,120,1.0,1.0,2,120,1.0,1.0
59,79,2,122,2,81,0.664,1.0,2,110,0.902,1.0,2,119,0.975,1.0,2,120,0.984,1.0,2,122,1.0,1.0,2,122,1.0,1.0,2,122,1.0,1.0
60,80,2,124,1,82,0.661,0.5,1,111,0.895,0.5,1,120,0.968,0.5,2,122,0.984,1.0,2,124,1.0,1.0,2,124,1.0,1.0,2,124,1.0,1.0
61,81,3,127,3,85,0.669,1.0,3,114,0.898,1.0,3,123,0.969,1.0,3,125,0.984,1.0,3,127,1.0,1.0,3,127,1.0,1.0,3,127,1.0,1.0
62,82,5,132,4,89,0.674,0.8,4,118,0.894,0.8,5,128,0.97,1.0,5,130,0.985,1.0,5,132,1.0,1.0,5,132,1.0,1.0,5,132,1.0,1.0
63,83,5,137,2,91,0.664,0.4,5,123,0.898,1.0,5,133,0.971,1.0,5,135,0.985,1.0,5,137,1.0,1.0,5,137,1.0,1.0,5,137,1.0,1.0
64,84,1,138,1,92,0.667,1.0,1,124,0.899,1.0,1,134,0.971,1.0,1,136,0.986,1.0,1,138,1.0,1.0,1,138,1.0,1.0,1,138,1.0,1.0
65,85,2,140,0,92,0.657,0.0,2,126,0.9,1.0,2,136,0.971,1.0,2,138,0.986,1.0,2,140,1.0,1.0,2,140,1.0,1.0,2,140,1.0,1.0
66,86,2,142,2,94,0.662,1.0,2,128,0.901,1.0,2,138,0.972,1.0,2,140,0.986,1.0,2,142,1.0,1.0,2,142,1.0,1.0,2,142,1.0,1.0
67,87,4,146,2,96,0.658,0.5,3,131,0.897,0.75,3,141,0.966,0.75,3,143,0.979,0.75,4,146,1.0,1.0,4,146,1.0,1.0,4,146,1.0,1.0
68,88,4,150,3,99,0.66,0.75,4,135,0.9,1.0,4,145,0.967,1.0,4,147,0.98,1.0,4,150,1.0,1.0,4,150,1.0,1.0,4,150,1.0,1.0
69,89,1,151,1,100,0.662,1.0,1,136,0.901,1.0,1,146,0.967,1.0,1,148,0.98,1.0,1,151,1.0,1.0,1,151,1.0,1.0,1,151,1.0,1.0
70,90,3,154,2,102,0.662,0.667,2,138,0.896,0.667,2,148,0.961,0.667,3,151,0.981,1.0,3,154,1.0,1.0,3,154,1.0,1.0,3,154,1.0,1.0
71,91,2,156,2,104,0.667,1.0,2,140,0.897,1.0,2,150,0.962,1.0,2,153,0.981,1.0,2,156,1.0,1.0,2,156,1.0,1.0,2,156,1.0,1.0
72,92,3,159,3,107,0.673,1.0,3,143,0.899,1.0,3,153,0.962,1.0,3,156,0.981,1.0,3,159,1.0,1.0,3,159,1.0,1.0,3,159,1.0,1.0
73,93,1,160,1,108,0.675,1.0,1,144,0.9,1.0,1,154,0.962,1.0,1,157,0.981,1.0,1,160,1.0,1.0,1,160,1.0,1.0,1,160,1.0,1.0
74,94,5,165,4,112,0.679,0.8,5,149,0.903,1.0,5,159,0.964,1.0,5,162,0.982,1.0,5,165,1.0,1.0,5,165,1.0,1.0,5,165,1.0,1.0
75,95,5,170,3,115,0.676,0.6,5,154,0.906,1.0,5,164,0.965,1.0,5,167,0.982,1.0,5,170,1.0,1.0,5,170,1.0,1.0,5,170,1.0,1.0
76,97,2,172,2,117,0.68,1.0,2,156,0.907,1.0,2,166,0.965,1.0,2,169,0.983,1.0,2,172,1.0,1.0,2,172,1.0,1.0,2,172,1.0,1.0
77,98,2,174,1,118,0.678,0.5,1,157,0.902,0.5,1,167,0.96,0.5,2,171,0.983,1.0,2,174,1.0,1.0,2,174,1.0,1.0,2,174,1.0,1.0
78,99,2,176,2,120,0.682,1.0,2,159,0.903,1.0,2,169,0.96,1.0,2,173,0.983,1.0,2,176,1.0,1.0,2,176,1.0,1.0,2,176,1.0,1.0
79,100,5,181,4,124,0.685,0.8,5,164,0.906,1.0,5,174,0.961,1.0,5,178,0.983,1.0,5,181,1.0,1.0,5,181,1.0,1.0,5,181,1.0,1.0
80,101,1,182,0,124,0.681,0.0,0,164,0.901,0.0,1,175,0.962,1.0,1,179,0.984,1.0,1,182,1.0,1.0,1,182,1.0,1.0,1,182,1.0,1.0
81,102,4,186,2,126,0.677,0.5,4,168,0.903,1.0,4,179,0.962,1.0,4,183,0.984,1.0,4,186,1.0,1.0,4,186,1.0,1.0,4,186,1.0,1.0
82,104,2,188,1,127,0.676,0.5,1,169,0.899,0.5,2,181,0.963,1.0,2,185,0.984,1.0,2,188,1.0,1.0,2,188,1.0,1.0,2,188,1.0,1.0
83,106,1,189,0,127,0.672,0.0,1,170,0.899,1.0,1,182,0.963,1.0,1,186,0.984,1.0,1,189,1.0,1.0,1,189,1.0,1.0,1,189,1.0,1.0
84,107,6,195,4,131,0.672,0.667,4,174,0.892,0.667,5,187,0.959,0.833,6,192,0.985,1.0,6,195,1.0,1.0,6,195,1.0,1.0,6,195,1.0,1.0
85,108,2,197,0,131,0.665,0.0,0,174,0.883,0.0,0,187,0.949,0.0,2,194,0.985,1.0,2,197,1.0,1.0,2,197,1.0,1.0,2,197,1.0,1.0
86,109,4,201,3,134,0.667,0.75,4,178,0.886,1.0,4,191,0.95,1.0,4,198,0.985,1.0,4,201,1.0,1.0,4,201,1.0,1.0,4,201,1.0,1.0
87,111,2,203,1,135,0.665,0.5,2,180,0.887,1.0,2,193,0.951,1.0,2,200,0.985,1.0,2,203,1.0,1.0,2,203,1.0,1.0,2,203,1.0,1.0
88,112,4,207,4,139,0.671,1.0,4,184,0.889,1.0,4,197,0.952,1.0,4,204,0.986,1.0,4,207,1.0,1.0,4,207,1.0,1.0,4,207,1.0,1.0
89,113,6,213,5,144,0.676,0.833,5,189,0.887,0.833,5,202,0.948,0.833,5,209,0.981,0.833,5,212,0.995,0.833,6,213,1.0,1.0,6,213,1.0,1.0
90,115,2,215,1,145,0.674,0.5,1,190,0.884,0.5,1,203,0.944,0.5,2,211,0.981,1.0,2,214,0.995,1.0,2,215,1.0,1.0,2,215,1.0,1.0
91,116,1,216,1,146,0.676,1.0,1,191,0.884,1.0,1,204,0.944,1.0,1,212,0.981,1.0,1,215,0.995,1.0,1,216,1.0,1.0,1,216,1.0,1.0
92,117,3,219,2,148,0.676,0.667,3,194,0.886,1.0,3,207,0.945,1.0,3,215,0.982,1.0,3,218,0.995,1.0,3,219,1.0,1.0,3,219,1.0,1.0
93,118,8,227,6,154,0.678,0.75,8,202,0.89,1.0,8,215,0.947,1.0,8,223,0.982,1.0,8,226,0.996,1.0,8,227,1.0,1.0,8,227,1.0,1.0
94,119,3,230,2,156,0.678,0.667,3,205,0.891,1.0,3,218,0.948,1.0,3,226,0.983,1.0,3,229,0.996,1.0,3,230,1.0,1.0,3,230,1.0,1.0
95,120,1,231,1,157,0.68,1.0,1,206,0.892,1.0,1,219,0.948,1.0,1,227,0.983,1.0,1,230,0.996,1.0,1,231,1.0,1.0,1,231,1.0,1.0
96,121,4,235,2,159,0.677,0.5,2,208,0.885,0.5,2,221,0.94,0.5,4,231,0.983,1.0,4,234,0.996,1.0,4,235,1.0,1.0,4,235,1.0,1.0
97,123,1,236,1,160,0.678,1.0,1,209,0.886,1.0,1,222,0.941,1.0,1,232,0.983,1.0,1,235,0.996,1.0,1,236,1.0,1.0,1,236,1.0,1.0
98,124,4,240,1,161,0.671,0.25,4,213,0.888,1.0,4,226,0.942,1.0,4,236,0.983,1.0,4,239,0.996,1.0,4,240,1.0,1.0,4,240,1.0,1.0
99,125,2,242,0,161,0.665,0.0,2,215,0.888,1.0,2,228,0.942,1.0,2,238,0.983,1.0,2,241,0.996,1.0,2,242,1.0,1.0,2,242,1.0,1.0
100,126,2,244,1,162,0.664,0.5,2,217,0.889,1.0,2,230,0.943,1.0,2,240,0.984,1.0,2,243,0.996,1.0,2,244,1.0,1.0,2,244,1.0,1.0
101,127,2,246,2,164,0.667,1.0,2,219,0.89,1.0,2,232,0.943,1.0,2,242,0.984,1.0,2,245,0.996,1.0,2,246,1.0,1.0,2,246,1.0,1.0
102,128,5,251,2,166,0.661,0.4,4,223,0.888,0.8,4,236,0.94,0.8,5,247,0.984,1.0,5,250,0.996,1.0,5,251,1.0,1.0,5,251,1.0,1.0
103,129,5,256,1,167,0.652,0.2,2,225,0.879,0.4,3,239,0.934,0.6,5,252,0.984,1.0,5,255,0.996,1.0,5,256,1.0,1.0,5,256,1.0,1.0
104,130,1,257,1,168,0.654,1.0,1,226,0.879,1.0,1,240,0.934,1.0,1,253,0.984,1.0,1,256,0.996,1.0,1,257,1.0,1.0,1,257,1.0,1.0
105,131,1,258,1,169,0.655,1.0,1,227,0.88,1.0,1,241,0.934,1.0,1,254,0.984,1.0,1,257,0.996,1.0,1,258,1.0,1.0,1,258,1.0,1.0
106,132,3,261,0,169,0.648,0.0,3,230,0.881,1.0,3,244,0.935,1.0,3,257,0.985,1.0,3,260,0.996,1.0,3,261,1.0,1.0,3,261,1.0,1.0
107,133,2,263,0,169,0.643,0.0,2,232,0.882,1.0,2,246,0.935,1.0,2,259,0.985,1.0,2,262,0.996,1.0,2,263,1.0,1.0,2,263,1.0,1.0
108,134,1,264,0,169,0.64,0.0,1,233,0.883,1.0,1,247,0.936,1.0,1,260,0.985,1.0,1,263,0.996,1.0,1,264,1.0,1.0,1,264,1.0,1.0
109,135,3,267,1,170,0.637,0.333,2,235,0.88,0.667,3,250,0.936,1.0,3,263,0.985,1.0,3,266,0.996,1.0,3,267,1.0,1.0,3,267,1.0,1.0
110,136,5,272,3,173,0.636,0.6,4,239,0.879,0.8,4,254,0.934,0.8,5,268,0.985,1.0,5,271,0.996,1.0,5,272,1.0,1.0,5,272,1.0,1.0
111,137,5,277,4,177,0.639,0.8,5,244,0.881,1.0,5,259,0.935,1.0,5,273,0.986,1.0,5,276,0.996,1.0,5,277,1.0,1.0,5,277,1.0,1.0
112,138,3,280,1,178,0.636,0.333,2,246,0.879,0.667,3,262,0.936,1.0,3,276,0.986,1.0,3,279,0.996,1.0,3,280,1.0,1.0,3,280,1.0,1.0
113,139,4,284,4,182,0.641,1.0,4,250,0.88,1.0,4,266,0.937,1.0,4,280,0.986,1.0,4,283,0.996,1.0,4,284,1.0,1.0,4,284,1.0,1.0
114,140,1,285,1,183,0.642,1.0,1,251,0.881,1.0,1,267,0.937,1.0,1,281,0.986,1.0,1,284,0.996,1.0,1,285,1.0,1.0,1,285,1.0,1.0
115,141,4,289,2,185,0.64,0.5,4,255,0.882,1.0,4,271,0.938,1.0,4,285,0.986,1.0,4,288,0.997,1.0,4,289,1.0,1.0,4,289,1.0,1.0
116,142,2,291,1,186,0.639,0.5,2,257,0.883,1.0,2,273,0.938,1.0,2,287,0.986,1.0,2,290,0.997,1.0,2,291,1.0,1.0,2,291,1.0,1.0
117,144,1,292,1,187,0.64,1.0,1,258,0.884,1.0,1,274,0.938,1.0,1,288,0.986,1.0,1,291,0.997,1.0,1,292,1.0,1.0,1,292,1.0,1.0
118,145,2,294,0,187,0.636,0.0,1,259,0.881,0.5,2,276,0.939,1.0,2,290,0.986,1.0,2,293,0.997,1.0,2,294,1.0,1.0,2,294,1.0,1.0
119,146,2,296,2,189,0.639,1.0,2,261,0.882,1.0,2,278,0.939,1.0,2,292,0.986,1.0,2,295,0.997,1.0,2,296,1.0,1.0,2,296,1.0,1.0
120,148,1,297,1,190,0.64,1.0,1,262,0.882,1.0,1,279,0.939,1.0,1,293,0.987,1.0,1,296,0.997,1.0,1,297,1.0,1.0,1,297,1.0,1.0
121,149,6,303,2,192,0.634,0.333,4,266,0.878,0.667,5,284,0.937,0.833,6,299,0.987,1.0,6,302,0.997,1.0,6,303,1.0,1.0,6,303,1.0,1.0
122,150,3,306,2,194,0.634,0.667,2,268,0.876,0.667,2,286,0.935,0.667,3,302,0.987,1.0,3,305,0.997,1.0,3,306,1.0,1.0,3,306,1.0,1.0
123,151,3,309,1,195,0.631,0.333,3,271,0.877,1.0,3,289,0.935,1.0,3,305,0.987,1.0,3,308,0.997,1.0,3,309,1.0,1.0,3,309,1.0,1.0
124,152,3,312,1,196,0.628,0.333,3,274,0.878,1.0,3,292,0.936,1.0,3,308,0.987,1.0,3,311,0.997,1.0,3,312,1.0,1.0,3,312,1.0,1.0
125,153,3,315,2,198,0.629,0.667,3,277,0.879,1.0,3,295,0.937,1.0,3,311,0.987,1.0,3,314,0.997,1.0,3,315,1.0,1.0,3,315,1.0,1.0
126,154,3,318,1,199,0.626,0.333,3,280,0.881,1.0,3,298,0.937,1.0,3,314,0.987,1.0,3,317,0.997,1.0,3,318,1.0,1.0,3,318,1.0,1.0
127,155,6,324,1,200,0.617,0.167,4,284,0.877,0.667,4,302,0.932,0.667,6,320,0.988,1.0,6,323,0.997,1.0,6,324,1.0,1.0,6,324,1.0,1.0
128,156,1,325,1,201,0.618,1.0,1,285,0.877,1.0,1,303,0.932,1.0,1,321,0.988,1.0,1,324,0.997,1.0,1,325,1.0,1.0,1,325,1.0,1.0
129,157,1,326,0,201,0.617,0.0,1,286,0.877,1.0,1,304,0.933,1.0,1,322,0.988,1.0,1,325,0.997,1.0,1,326,1.0,1.0,1,326,1.0,1.0
130,158,2,328,1,202,0.616,0.5,1,287,0.875,0.5,2,306,0.933,1.0,2,324,0.988,1.0,2,327,0.997,1.0,2,328,1.0,1.0,2,328,1.0,1.0
131,159,2,330,1,203,0.615,0.5,1,288,0.873,0.5,1,307,0.93,0.5,2,326,0.988,1.0,2,329,0.997,1.0,2,330,1.0,1.0,2,330,1.0,1.0
132,160,1,331,1,204,0.616,1.0,1,289,0.873,1.0,1,308,0.931,1.0,1,327,0.988,1.0,1,330,0.997,1.0,1,331,1.0,1.0,1,331,1.0,1.0
133,161,1,332,0,204,0.614,0.0,1,290,0.873,1.0,1,309,0.931,1.0,1,328,0.988,1.0,1,331,0.997,1.0,1,332,1.0,1.0,1,332,1.0,1.0
134,162,3,335,1,205,0.612,0.333,2,292,0.872,0.667,2,311,0.928,0.667,3,331,0.988,1.0,3,334,0.997,1.0,3,335,1.0,1.0,3,335,1.0,1.0
135,163,3,338,1,206,0.609,0.333,3,295,0.873,1.0,3,314,0.929,1.0,3,334,0.988,1.0,3,337,0.997,1.0,3,338,1.0,1.0,3,338,1.0,1.0
136,164,2,340,2,208,0.612,1.0,2,297,0.874,1.0,2,316,0.929,1.0,2,336,0.988,1.0,2,339,0.997,1.0,2,340,1.0,1.0,2,340,1.0,1.0
137,165,1,341,0,208,0.61,0.0,1,298,0.874,1.0,1,317,0.93,1.0,1,337,0.988,1.0,1,340,0.997,1.0,1,341,1.0,1.0,1,341,1.0,1.0
138,167,2,343,0,208,0.606,0.0,2,300,0.875,1.0,2,319,0.93,1.0,2,339,0.988,1.0,2,342,0.997,1.0,2,343,1.0,1.0,2,343,1.0,1.0
139,168,3,346,2,210,0.607,0.667,3,303,0.876,1.0,3,322,0.931,1.0,3,342,0.988,1.0,3,345,0.997,1.0,3,346,1.0,1.0,3,346,1.0,1.0
140,169,2,348,0,210,0.603,0.0,1,304,0.874,0.5,1,323,0.928,0.5,2,344,0.989,1.0,2,347,0.997,1.0,2,348,1.0,1.0,2,348,1.0,1.0
141,170,4,352,2,212,0.602,0.5,4,308,0.875,1.0,4,327,0.929,1.0,4,348,0.989,1.0,4,351,0.997,1.0,4,352,1.0,1.0,4,352,1.0,1.0
142,171,3,355,1,213,0.6,0.333,3,311,0.876,1.0,3,330,0.93,1.0,3,351,0.989,1.0,3,354,0.997,1.0,3,355,1.0,1.0,3,355,1.0,1.0
143,172,4,359,2,215,0.599,0.5,3,314,0.875,0.75,3,333,0.928,0.75,4,355,0.989,1.0,4,358,0.997,1.0,4,359,1.0,1.0,4,359,1.0,1.0
144,173,1,360,1,216,0.6,1.0,1,315,0.875,1.0,1,334,0.928,1.0,1,356,0.989,1.0,1,359,0.997,1.0,1,360,1.0,1.0,1,360,1.0,1.0
145,174,1,361,1,217,0.601,1.0,1,316,0.875,1.0,1,335,0.928,1.0,1,357,0.989,1.0,1,360,0.997,1.0,1,361,1.0,1.0,1,361,1.0,1.0
146,176,2,363,1,218,0.601,0.5,2,318,0.876,1.0,2,337,0.928,1.0,2,359,0.989,1.0,2,362,0.997,1.0,2,363,1.0,1.0,2,363,1.0,1.0
147,177,2,365,1,219,0.6,0.5,2,320,0.877,1.0,2,339,0.929,1.0,2,361,0.989,1.0,2,364,0.997,1.0,2,365,1.0,1.0,2,365,1.0,1.0
148,179,3,368,0,219,0.595,0.0,2,322,0.875,0.667,3,342,0.929,1.0,3,364,0.989,1.0,3,367,0.997,1.0,3,368,1.0,1.0,3,368,1.0,1.0
149,180,1,369,1,220,0.596,1.0,1,323,0.875,1.0,1,343,0.93,1.0,1,365,0.989,1.0,1,368,0.997,1.0,1,369,1.0,1.0,1,369,1.0,1.0
150,181,3,372,1,221,0.594,0.333,3,326,0.876,1.0,3,346,0.93,1.0,3,368,0.989,1.0,3,371,0.997,1.0,3,372,1.0,1.0,3,372,1.0,1.0
151,182,4,376,3,224,0.596,0.75,4,330,0.878,1.0,4,350,0.931,1.0,4,372,0.989,1.0,4,375,0.997,1.0,4,376,1.0,1.0,4,376,1.0,1.0
152,183,4,380,2,226,0.595,0.5,4,334,0.879,1.0,4,354,0.932,1.0,4,376,0.989,1.0,4,379,0.997,1.0,4,380,1.0,1.0,4,380,1.0,1.0
153,184,7,387,2,228,0.589,0.286,5,339,0.876,0.714,5,359,0.928,0.714,7,383,0.99,1.0,7,386,0.997,1.0,7,387,1.0,1.0,7,387,1.0,1.0
154,185,3,390,1,229,0.587,0.333,3,342,0.877,1.0,3,362,0.928,1.0,3,386,0.99,1.0,3,389,0.997,1.0,3,390,1.0,1.0,3,390,1.0,1.0
155,186,4,394,2,231,0.586,0.5,3,345,0.876,0.75,3,365,0.926,0.75,4,390,0.99,1.0,4,393,0.997,1.0,4,394,1.0,1.0,4,394,1.0,1.0
156,187,4,398,0,231,0.58,0.0,3,348,0.874,0.75,4,369,0.927,1.0,4,394,0.99,1.0,4,397,0.997,1.0,4,398,1.0,1.0,4,398,1.0,1.0
157,188,2,400,0,231,0.578,0.0,1,349,0.872,0.5,1,370,0.925,0.5,2,396,0.99,1.0,2,399,0.998,1.0,2,400,1.0,1.0,2,400,1.0,1.0
158,189,1,401,1,232,0.579,1.0,1,350,0.873,1.0,1,371,0.925,1.0,1,397,0.99,1.0,1,400,0.998,1.0,1,401,1.0,1.0,1,401,1.0,1.0
159,190,3,404,1,233,0.577,0.333,1,351,0.869,0.333,1,372,0.921,0.333,3,400,0.99,1.0,3,403,0.998,1.0,3,404,1.0,1.0,3,404,1.0,1.0
160,191,4,408,4,237,0.581,1.0,4,355,0.87,1.0,4,376,0.922,1.0,4,404,0.99,1.0,4,407,0.998,1.0,4,408,1.0,1.0,4,408,1.0,1.0
161,192,1,409,0,237,0.579,0.0,1,356,0.87,1.0,1,377,0.922,1.0,1,405,0.99,1.0,1,408,0.998,1.0,1,409,1.0,1.0,1,409,1.0,1.0
162,193,4,413,3,240,0.581,0.75,4,360,0.872,1.0,4,381,0.923,1.0,4,409,0.99,1.0,4,412,0.998,1.0,4,413,1.0,1.0,4,413,1.0,1.0
163,194,2,415,1,241,0.581,0.5,2,362,0.872,1.0,2,383,0.923,1.0,2,411,0.99,1.0,2,414,0.998,1.0,2,415,1.0,1.0,2,415,1.0,1.0
164,195,2,417,1,242,0.58,0.5,1,363,0.871,0.5,1,384,0.921,0.5,2,413,0.99,1.0,2,416,0.998,1.0,2,417,1.0,1.0,2,417,1.0,1.0
165,196,3,420,2,244,0.581,0.667,3,366,0.871,1.0,3,387,0.921,1.0,3,416,0.99,1.0,3,419,0.998,1.0,3,420,1.0,1.0,3,420,1.0,1.0
166,197,3,423,2,246,0.582,0.667,3,369,0.872,1.0,3,390,0.922,1.0,3,419,0.991,1.0,3,422,0.998,1.0,3,423,1.0,1.0,3,423,1.0,1.0
167,198,2,425,2,248,0.584,1.0,2,371,0.873,1.0,2,392,0.922,1.0,2,421,0.991,1.0,2,424,0.998,1.0,2,425,1.0,1.0,2,425,1.0,1.0
168,199,3,428,2,250,0.584,0.667,3,374,0.874,1.0,3,395,0.923,1.0,3,424,0.991,1.0,3,427,0.998,1.0,3,428,1.0,1.0,3,428,1.0,1.0
169,200,4,432,2,252,0.583,0.5,2,376,0.87,0.5,3,398,0.921,0.75,3,427,0.988,0.75,4,431,0.998,1.0,4,432,1.0,1.0,4,432,1.0,1.0
170,201,1,433,0,252,0.582,0.0,1,377,0.871,1.0,1,399,0.921,1.0,1,428,0.988,1.0,1,432,0.998,1.0,1,433,1.0,1.0,1,433,1.0,1.0
171,202,1,434,1,253,0.583,1.0,1,378,0.871,1.0,1,400,0.922,1.0,1,429,0.988,1.0,1,433,0.998,1.0,1,434,1.0,1.0,1,434,1.0,1.0
172,203,3,437,2,255,0.584,0.667,2,380,0.87,0.667,2,402,0.92,0.667,3,432,0.989,1.0,3,436,0.998,1.0,3,437,1.0,1.0,3,437,1.0,1.0
173,204,4,441,2,257,0.583,0.5,2,382,0.866,0.5,3,405,0.918,0.75,3,435,0.986,0.75,4,440,0.998,1.0,4,441,1.0,1.0,4,441,1.0,1.0
174,205,5,446,0,257,0.576,0.0,4,386,0.865,0.8,5,410,0.919,1.0,5,440,0.987,1.0,5,445,0.998,1.0,5,446,1.0,1.0,5,446,1.0,1.0
175,206,2,448,1,258,0.576,0.5,1,387,0.864,0.5,2,412,0.92,1.0,2,442,0.987,1.0,2,447,0.998,1.0,2,448,1.0,1.0,2,448,1.0,1.0
176,207,5,453,1,259,0.572,0.2,2,389,0.859,0.4,5,417,0.921,1.0,5,447,0.987,1.0,5,452,0.998,1.0,5,453,1.0,1.0,5,453,1.0,1.0
177,208,2,455,1,260,0.571,0.5,1,390,0.857,0.5,2,419,0.921,1.0,2,449,0.987,1.0,2,454,0.998,1.0,2,455,1.0,1.0,2,455,1.0,1.0
178,210,4,459,1,261,0.569,0.25,1,391,0.852,0.25,2,421,0.917,0.5,3,452,0.985,0.75,4,458,0.998,1.0,4,459,1.0,1.0,4,459,1.0,1.0
179,211,3,462,1,262,0.567,0.333,2,393,0.851,0.667,2,423,0.916,0.667,2,454,0.983,0.667,3,461,0.998,1.0,3,462,1.0,1.0,3,462,1.0,1.0
180,212,1,463,0,262,0.566,0.0,0,393,0.849,0.0,0,423,0.914,0.0,1,455,0.983,1.0,1,462,0.998,1.0,1,463,1.0,1.0,1,463,1.0,1.0
181,213,1,464,1,263,0.567,1.0,1,394,0.849,1.0,1,424,0.914,1.0,1,456,0.983,1.0,1,463,0.998,1.0,1,464,1.0,1.0,1,464,1.0,1.0
182,214,5,469,1,264,0.563,0.2,2,396,0.844,0.4,3,427,0.91,0.6,5,461,0.983,1.0,5,468,0.998,1.0,5,469,1.0,1.0,5,469,1.0,1.0
183,215,1,470,1,265,0.564,1.0,1,397,0.845,1.0,1,428,0.911,1.0,1,462,0.983,1.0,1,469,0.998,1.0,1,470,1.0,1.0,1,470,1.0,1.0
184,216,6,476,4,269,0.565,0.667,6,403,0.847,1.0,6,434,0.912,1.0,6,468,0.983,1.0,6,475,0.998,1.0,6,476,1.0,1.0,6,476,1.0,1.0
185,217,2,478,1,270,0.565,0.5,2,405,0.847,1.0,2,436,0.912,1.0,2,470,0.983,1.0,2,477,0.998,1.0,2,478,1.0,1.0,2,478,1.0,1.0
186,220,2,480,0,270,0.562,0.0,1,406,0.846,0.5,1,437,0.91,0.5,2,472,0.983,1.0,2,479,0.998,1.0,2,480,1.0,1.0,2,480,1.0,1.0
187,221,3,483,2,272,0.563,0.667,3,409,0.847,1.0,3,440,0.911,1.0,3,475,0.983,1.0,3,482,0.998,1.0,3,483,1.0,1.0,3,483,1.0,1.0
188,222,2,485,2,274,0.565,1.0,2,411,0.847,1.0,2,442,0.911,1.0,2,477,0.984,1.0,2,484,0.998,1.0,2,485,1.0,1.0,2,485,1.0,1.0
189,223,3,488,0,274,0.561,0.0,2,413,0.846,0.667,3,445,0.912,1.0,3,480,0.984,1.0,3,487,0.998,1.0,3,488,1.0,1.0,3,488,1.0,1.0
190,224,4,492,1,275,0.559,0.25,3,416,0.846,0.75,4,449,0.913,1.0,4,484,0.984,1.0,4,491,0.998,1.0,4,492,1.0,1.0,4,492,1.0,1.0
191,225,6,498,2,277,0.556,0.333,5,421,0.845,0.833,6,455,0.914,1.0,6,490,0.984,1.0,6,497,0.998,1.0,6,498,1.0,1.0,6,498,1.0,1.0
192,226,3,501,2,279,0.557,0.667,3,424,0.846,1.0,3,458,0.914,1.0,3,493,0.984,1.0,3,500,0.998,1.0,3,501,1.0,1.0,3,501,1.0,1.0
193,227,2,503,1,280,0.557,0.5,2,426,0.847,1.0,2,460,0.915,1.0,2,495,0.984,1.0,2,502,0.998,1.0,2,503,1.0,1.0,2,503,1.0,1.0
194,228,1,504,0,280,0.556,0.0,1,427,0.847,1.0,1,461,0.915,1.0,1,496,0.984,1.0,1,503,0.998,1.0,1,504,1.0,1.0,1,504,1.0,1.0
195,229,1,505,0,280,0.554,0.0,1,428,0.848,1.0,1,462,0.915,1.0,1,497,0.984,1.0,1,504,0.998,1.0,1,505,1.0,1.0,1,505,1.0,1.0
196,230,3,508,1,281,0.553,0.333,1,429,0.844,0.333,2,464,0.913,0.667,3,500,0.984,1.0,3,507,0.998,1.0,3,508,1.0,1.0,3,508,1.0,1.0
197,231,2,510,1,282,0.553,0.5,1,430,0.843,0.5,2,466,0.914,1.0,2,502,0.984,1.0,2,509,0.998,1.0,2,510,1.0,1.0,2,510,1.0,1.0
198,233,2,512,1,283,0.553,0.5,1,431,0.842,0.5,2,468,0.914,1.0,2,504,0.984,1.0,2,511,0.998,1.0,2,512,1.0,1.0,2,512,1.0,1.0
199,234,2,514,1,284,0.553,0.5,2,433,0.842,1.0,2,470,0.914,1.0,2,506,0.984,1.0,2,513,0.998,1.0,2,514,1.0,1.0,2,514,1.0,1.0
200,236,2,516,2,286,0.554,1.0,2,435,0.843,1.0,2,472,0.915,1.0,2,508,0.984,1.0,2,515,0.998,1.0,2,516,1.0,1.0,2,516,1.0,1.0
201,237,2,518,0,286,0.552,0.0,1,436,0.842,0.5,1,473,0.913,0.5,2,510,0.985,1.0,2,517,0.998,1.0,2,518,1.0,1.0,2,518,1.0,1.0
202,238,2,520,0,286,0.55,0.0,2,438,0.842,1.0,2,475,0.913,1.0,2,512,0.985,1.0,2,519,0.998,1.0,2,520,1.0,1.0,2,520,1.0,1.0
203,239,3,523,0,286,0.547,0.0,2,440,0.841,0.667,3,478,0.914,1.0,3,515,0.985,1.0,3,522,0.998,1.0,3,523,1.0,1.0,3,523,1.0,1.0
204,240,2,525,2,288,0.549,1.0,2,442,0.842,1.0,2,480,0.914,1.0,2,517,0.985,1.0,2,524,0.998,1.0,2,525,1.0,1.0,2,525,1.0,1.0
205,241,2,527,0,288,0.546,0.0,1,443,0.841,0.5,1,481,0.913,0.5,1,518,0.983,0.5,2,526,0.998,1.0,2,527,1.0,1.0,2,527,1.0,1.0
206,243,1,528,0,288,0.545,0.0,1,444,0.841,1.0,1,482,0.913,1.0,1,519,0.983,1.0,1,527,0.998,1.0,1,528,1.0,1.0,1,528,1.0,1.0
207,244,3,531,1,289,0.544,0.333,2,446,0.84,0.667,2,484,0.911,0.667,3,522,0.983,1.0,3,530,0.998,1.0,3,531,1.0,1.0,3,531,1.0,1.0
208,245,6,537,1,290,0.54,0.167,4,450,0.838,0.667,4,488,0.909,0.667,5,527,0.981,0.833,6,536,0.998,1.0,6,537,1.0,1.0,6,537,1.0,1.0
209,247,2,539,2,292,0.542,1.0,2,452,0.839,1.0,2,490,0.909,1.0,2,529,0.981,1.0,2,538,0.998,1.0,2,539,1.0,1.0,2,539,1.0,1.0
210,248,2,541,1,293,0.542,0.5,1,453,0.837,0.5,2,492,0.909,1.0,2,531,0.982,1.0,2,540,0.998,1.0,2,541,1.0,1.0,2,541,1.0,1.0
211,249,4,545,3,296,0.543,0.75,4,457,0.839,1.0,4,496,0.91,1.0,4,535,0.982,1.0,4,544,0.998,1.0,4,545,1.0,1.0,4,545,1.0,1.0
212,250,4,549,2,298,0.543,0.5,3,460,0.838,0.75,4,500,0.911,1.0,4,539,0.982,1.0,4,548,0.998,1.0,4,549,1.0,1.0,4,549,1.0,1.0
213,251,4,553,3,301,0.544,0.75,3,463,0.837,0.75,3,503,0.91,0.75,4,543,0.982,1.0,4,552,0.998,1.0,4,553,1.0,1.0,4,553,1.0,1.0
214,252,2,555,1,302,0.544,0.5,1,464,0.836,0.5,2,505,0.91,1.0,2,545,0.982,1.0,2,554,0.998,1.0,2,555,1.0,1.0,2,555,1.0,1.0
215,253,7,562,1,303,0.539,0.143,3,467,0.831,0.429,6,511,0.909,0.857,7,552,0.982,1.0,7,561,0.998,1.0,7,562,1.0,1.0,7,562,1.0,1.0
216,254,5,567,1,304,0.536,0.2,2,469,0.827,0.4,4,515,0.908,0.8,4,556,0.981,0.8,5,566,0.998,1.0,5,567,1.0,1.0,5,567,1.0,1.0
217,255,3,570,0,304,0.533,0.0,2,471,0.826,0.667,2,517,0.907,0.667,3,559,0.981,1.0,3,569,0.998,1.0,3,570,1.0,1.0,3,570,1.0,1.0
218,256,3,573,2,306,0.534,0.667,2,473,0.825,0.667,3,520,0.908,1.0,3,562,0.981,1.0,3,572,0.998,1.0,3,573,1.0,1.0,3,573,1.0,1.0
219,257,5,578,0,306,0.529,0.0,3,476,0.824,0.6,4,524,0.907,0.8,5,567,0.981,1.0,5,577,0.998,1.0,5,578,1.0,1.0,5,578,1.0,1.0
220,258,4,582,2,308,0.529,0.5,4,480,0.825,1.0,4,528,0.907,1.0,4,571,0.981,1.0,4,581,0.998,1.0,4,582,1.0,1.0,4,582,1.0,1.0
221,259,2,584,0,308,0.527,0.0,1,481,0.824,0.5,2,530,0.908,1.0,2,573,0.981,1.0,2,583,0.998,1.0,2,584,1.0,1.0,2,584,1.0,1.0
222,260,1,585,1,309,0.528,1.0,1,482,0.824,1.0,1,531,0.908,1.0,1,574,0.981,1.0,1,584,0.998,1.0,1,585,1.0,1.0,1,585,1.0,1.0
223,261,3,588,0,309,0.526,0.0,3,485,0.825,1.0,3,534,0.908,1.0,3,577,0.981,1.0,3,587,0.998,1.0,3,588,1.0,1.0,3,588,1.0,1.0
224,262,2,590,0,309,0.524,0.0,2,487,0.825,1.0,2,536,0.908,1.0,2,579,0.981,1.0,2,589,0.998,1.0,2,590,1.0,1.0,2,590,1.0,1.0
225,263,5,595,3,312,0.524,0.6,5,492,0.827,1.0,5,541,0.909,1.0,5,584,0.982,1.0,5,594,0.998,1.0,5,595,1.0,1.0,5,595,1.0,1.0
226,264,4,599,1,313,0.523,0.25,4,496,0.828,1.0,4,545,0.91,1.0,4,588,0.982,1.0,4,598,0.998,1.0,4,599,1.0,1.0,4,599,1.0,1.0
227,265,2,601,1,314,0.522,0.5,2,498,0.829,1.0,2,547,0.91,1.0,2,590,0.982,1.0,2,600,0.998,1.0,2,601,1.0,1.0,2,601,1.0,1.0
228,267,2,603,0,314,0.521,0.0,0,498,0.826,0.0,0,547,0.907,0.0,1,591,0.98,0.5,2,602,0.998,1.0,2,603,1.0,1.0,2,603,1.0,1.0
229,268,1,604,0,314,0.52,0.0,1,499,0.826,1.0,1,548,0.907,1.0,1,592,0.98,1.0,1,603,0.998,1.0,1,604,1.0,1.0,1,604,1.0,1.0
230,269,3,607,3,317,0.522,1.0,3,502,0.827,1.0,3,551,0.908,1.0,3,595,0.98,1.0,3,606,0.998,1.0,3,607,1.0,1.0,3,607,1.0,1.0
231,270,4,611,3,320,0.524,0.75,3,505,0.827,0.75,4,555,0.908,1.0,4,599,0.98,1.0,4,610,0.998,1.0,4,611,1.0,1.0,4,611,1.0,1.0
232,271,4,615,2,322,0.524,0.5,3,508,0.826,0.75,3,558,0.907,0.75,3,602,0.979,0.75,3,613,0.997,0.75,3,614,0.998,0.75,3,614,0.998,0.75
233,272,1,616,0,322,0.523,0.0,0,508,0.825,0.0,1,559,0.907,1.0,1,603,0.979,1.0,1,614,0.997,1.0,1,615,0.998,1.0,1,615,0.998,1.0
234,273,4,620,2,324,0.523,0.5,3,511,0.824,0.75,3,562,0.906,0.75,3,606,0.977,0.75,4,618,0.997,1.0,4,619,0.998,1.0,4,619,0.998,1.0
235,274,1,621,0,324,0.522,0.0,0,511,0.823,0.0,1,563,0.907,1.0,1,607,0.977,1.0,1,619,0.997,1.0,1,620,0.998,1.0,1,620,0.998,1.0
236,275,5,626,1,325,0.519,0.2,3,514,0.821,0.6,5,568,0.907,1.0,5,612,0.978,1.0,5,624,0.997,1.0,5,625,0.998,1.0,5,625,0.998,1.0
237,276,3,629,1,326,0.518,0.333,1,515,0.819,0.333,2,570,0.906,0.667,3,615,0.978,1.0,3,627,0.997,1.0,3,628,0.998,1.0,3,628,0.998,1.0
238,277,2,631,0,326,0.517,0.0,0,515,0.816,0.0,0,570,0.903,0.0,2,617,0.978,1.0,2,629,0.997,1.0,2,630,0.998,1.0,2,630,0.998,1.0
239,278,1,632,0,326,0.516,0.0,1,516,0.816,1.0,1,571,0.903,1.0,1,618,0.978,1.0,1,630,0.997,1.0,1,631,0.998,1.0,1,631,0.998,1.0
240,279,3,635,0,326,0.513,0.0,3,519,0.817,1.0,3,574,0.904,1.0,3,621,0.978,1.0,3,633,0.997,1.0,3,634,0.998,1.0,3,634,0.998,1.0
241,280,2,637,0,326,0.512,0.0,0,519,0.815,0.0,0,574,0.901,0.0,1,622,0.976,0.5,1,634,0.995,0.5,2,636,0.998,1.0,2,636,0.998,1.0
242,281,2,639,0,326,0.51,0.0,2,521,0.815,1.0,2,576,0.901,1.0,2,624,0.977,1.0,2,636,0.995,1.0,2,638,0.998,1.0,2,638,0.998,1.0
243,282,3,642,1,327,0.509,0.333,2,523,0.815,0.667,3,579,0.902,1.0,3,627,0.977,1.0,3,639,0.995,1.0,3,641,0.998,1.0,3,641,0.998,1.0
244,283,3,645,0,327,0.507,0.0,2,525,0.814,0.667,2,581,0.901,0.667,2,629,0.975,0.667,3,642,0.995,1.0,3,644,0.998,1.0,3,644,0.998,1.0
245,284,2,647,1,328,0.507,0.5,2,527,0.815,1.0,2,583,0.901,1.0,2,631,0.975,1.0,2,644,0.995,1.0,2,646,0.998,1.0,2,646,0.998,1.0
246,285,1,648,0,328,0.506,0.0,0,527,0.813,0.0,0,583,0.9,0.0,1,632,0.975,1.0,1,645,0.995,1.0,1,647,0.998,1.0,1,647,0.998,1.0
247,287,2,650,0,328,0.505,0.0,2,529,0.814,1.0,2,585,0.9,1.0,2,634,0.975,1.0,2,647,0.995,1.0,2,649,0.998,1.0,2,649,0.998,1.0
248,288,1,651,0,328,0.504,0.0,0,529,0.813,0.0,0,585,0.899,0.0,1,635,0.975,1.0,1,648,0.995,1.0,1,650,0.998,1.0,1,650,0.998,1.0
249,289,5,656,3,331,0.505,0.6,4,533,0.812,0.8,4,589,0.898,0.8,4,639,0.974,0.8,5,653,0.995,1.0,5,655,0.998,1.0,5,655,0.998,1.0
250,291,1,657,0,331,0.504,0.0,1,534,0.813,1.0,1,590,0.898,1.0,1,640,0.974,1.0,1,654,0.995,1.0,1,656,0.998,1.0,1,656,0.998,1.0
251,292,1,658,1,332,0.505,1.0,1,535,0.813,1.0,1,591,0.898,1.0,1,641,0.974,1.0,1,655,0.995,1.0,1,657,0.998,1.0,1,657,0.998,1.0
252,293,3,661,0,332,0.502,0.0,2,537,0.812,0.667,3,594,0.899,1.0,3,644,0.974,1.0,3,658,0.995,1.0,3,660,0.998,1.0,3,660,0.998,1.0
253,294,1,662,0,332,0.502,0.0,0,537,0.811,0.0,0,594,0.897,0.0,0,644,0.973,0.0,1,659,0.995,1.0,1,661,0.998,1.0,1,661,0.998,1.0
254,295,2,664,0,332,0.5,0.0,0,537,0.809,0.0,0,594,0.895,0.0,1,645,0.971,0.5,2,661,0.995,1.0,2,663,0.998,1.0,2,663,0.998,1.0
255,296,2,666,1,333,0.5,0.5,2,539,0.809,1.0,2,596,0.895,1.0,2,647,0.971,1.0,2,663,0.995,1.0,2,665,0.998,1.0,2,665,0.998,1.0
256,297,4,670,0,333,0.497,0.0,3,542,0.809,0.75,3,599,0.894,0.75,4,651,0.972,1.0,4,667,0.996,1.0,4,669,0.999,1.0,4,669,0.999,1.0
257,298,4,674,0,333,0.494,0.0,1,543,0.806,0.25,1,600,0.89,0.25,4,655,0.972,1.0,4,671,0.996,1.0,4,673,0.999,1.0,4,673,0.999,1.0
258,299,2,676,0,333,0.493,0.0,1,544,0.805,0.5,2,602,0.891,1.0,2,657,0.972,1.0,2,673,0.996,1.0,2,675,0.999,1.0,2,675,0.999,1.0
259,300,4,680,0,333,0.49,0.0,2,546,0.803,0.5,3,605,0.89,0.75,4,661,0.972,1.0,4,677,0.996,1.0,4,679,0.999,1.0,4,679,0.999,1.0
260,301,4,684,1,334,0.488,0.25,2,548,0.801,0.5,3,608,0.889,0.75,3,664,0.971,0.75,4,681,0.996,1.0,4,683,0.999,1.0,4,683,0.999,1.0
261,302,3,687,2,336,0.489,0.667,3,551,0.802,1.0,3,611,0.889,1.0,3,667,0.971,1.0,3,684,0.996,1.0,3,686,0.999,1.0,3,686,0.999,1.0
262,303,3,690,2,338,0.49,0.667,2,553,0.801,0.667,2,613,0.888,0.667,3,670,0.971,1.0,3,687,0.996,1.0,3,689,0.999,1.0,3,689,0.999,1.0
263,304,2,692,2,340,0.491,1.0,2,555,0.802,1.0,2,615,0.889,1.0,2,672,0.971,1.0,2,689,0.996,1.0,2,691,0.999,1.0,2,691,0.999,1.0
264,305,1,693,0,340,0.491,0.0,0,555,0.801,0.0,0,615,0.887,0.0,0,672,0.97,0.0,1,690,0.996,1.0,1,692,0.999,1.0,1,692,0.999,1.0
265,306,1,694,0,340,0.49,0.0,0,555,0.8,0.0,0,615,0.886,0.0,1,673,0.97,1.0,1,691,0.996,1.0,1,693,0.999,1.0,1,693,0.999,1.0
266,307,5,699,1,341,0.488,0.2,4,559,0.8,0.8,5,620,0.887,1.0,5,678,0.97,1.0,5,696,0.996,1.0,5,698,0.999,1.0,5,698,0.999,1.0
267,308,3,702,2,343,0.489,0.667,2,561,0.799,0.667,2,622,0.886,0.667,2,680,0.969,0.667,3,699,0.996,1.0,3,701,0.999,1.0,3,701,0.999,1.0
268,309,1,703,0,343,0.488,0.0,1,562,0.799,1.0,1,623,0.886,1.0,1,681,0.969,1.0,1,700,0.996,1.0,1,702,0.999,1.0,1,702,0.999,1.0
269,310,3,706,2,345,0.489,0.667,3,565,0.8,1.0,3,626,0.887,1.0,3,684,0.969,1.0,3,703,0.996,1.0,3,705,0.999,1.0,3,705,0.999,1.0
270,311,1,707,0,345,0.488,0.0,1,566,0.801,1.0,1,627,0.887,1.0,1,685,0.969,1.0,1,704,0.996,1.0,1,706,0.999,1.0,1,706,0.999,1.0
271,313,2,709,2,347,0.489,1.0,2,568,0.801,1.0,2,629,0.887,1.0,2,687,0.969,1.0,2,706,0.996,1.0,2,708,0.999,1.0,2,708,0.999,1.0
272,314,2,711,0,347,0.488,0.0,2,570,0.802,1.0,2,631,0.887,1.0,2,689,0.969,1.0,2,708,0.996,1.0,2,710,0.999,1.0,2,710,0.999,1.0
273,315,2,713,1,348,0.488,0.5,2,572,0.802,1.0,2,633,0.888,1.0,2,691,0.969,1.0,2,710,0.996,1.0,2,712,0.999,1.0,2,712,0.999,1.0
274,316,3,716,0,348,0.486,0.0,0,572,0.799,0.0,2,635,0.887,0.667,2,693,0.968,0.667,2,712,0.994,0.667,3,715,0.999,1.0,3,715,0.999,1.0
275,317,1,717,1,349,0.487,1.0,1,573,0.799,1.0,1,636,0.887,1.0,1,694,0.968,1.0,1,713,0.994,1.0,1,716,0.999,1.0,1,716,0.999,1.0
276,318,1,718,0,349,0.486,0.0,1,574,0.799,1.0,1,637,0.887,1.0,1,695,0.968,1.0,1,714,0.994,1.0,1,717,0.999,1.0,1,717,0.999,1.0
277,319,3,721,0,349,0.484,0.0,0,574,0.796,0.0,0,637,0.883,0.0,1,696,0.965,0.333,3,717,0.994,1.0,3,720,0.999,1.0,3,720,0.999,1.0
278,320,2,723,1,350,0.484,0.5,2,576,0.797,1.0,2,639,0.884,1.0,2,698,0.965,1.0,2,719,0.994,1.0,2,722,0.999,1.0,2,722,0.999,1.0
279,321,2,725,0,350,0.483,0.0,1,577,0.796,0.5,2,641,0.884,1.0,2,700,0.966,1.0,2,721,0.994,1.0,2,724,0.999,1.0,2,724,0.999,1.0
280,322,1,726,0,350,0.482,0.0,1,578,0.796,1.0,1,642,0.884,1.0,1,701,0.966,1.0,1,722,0.994,1.0,1,725,0.999,1.0,1,725,0.999,1.0
281,323,1,727,0,350,0.481,0.0,0,578,0.795,0.0,0,642,0.883,0.0,0,701,0.964,0.0,1,723,0.994,1.0,1,726,0.999,1.0,1,726,0.999,1.0
282,324,2,729,0,350,0.48,0.0,0,578,0.793,0.0,1,643,0.882,0.5,1,702,0.963,0.5,1,724,0.993,0.5,2,728,0.999,1.0,2,728,0.999,1.0
283,325,8,737,4,354,0.48,0.5,6,584,0.792,0.75,6,649,0.881,0.75,8,710,0.963,1.0,8,732,0.993,1.0,8,736,0.999,1.0,8,736,0.999,1.0
284,326,3,740,2,356,0.481,0.667,2,586,0.792,0.667,3,652,0.881,1.0,3,713,0.964,1.0,3,735,0.993,1.0,3,739,0.999,1.0,3,739,0.999,1.0
285,327,3,743,0,356,0.479,0.0,0,586,0.789,0.0,2,654,0.88,0.667,2,715,0.962,0.667,2,737,0.992,0.667,3,742,0.999,1.0,3,742,0.999,1.0
286,328,3,746,0,356,0.477,0.0,0,586,0.786,0.0,2,656,0.879,0.667,2,717,0.961,0.667,3,740,0.992,1.0,3,745,0.999,1.0,3,745,0.999,1.0
287,330,1,747,0,356,0.477,0.0,0,586,0.784,0.0,0,656,0.878,0.0,1,718,0.961,1.0,1,741,0.992,1.0,1,746,0.999,1.0,1,746,0.999,1.0
288,331,1,748,1,357,0.477,1.0,1,587,0.785,1.0,1,657,0.878,1.0,1,719,0.961,1.0,1,742,0.992,1.0,1,747,0.999,1.0,1,747,0.999,1.0
289,332,3,751,1,358,0.477,0.333,2,589,0.784,0.667,2,659,0.877,0.667,2,721,0.96,0.667,2,744,0.991,0.667,3,750,0.999,1.0,3,750,0.999,1.0
290,333,1,752,0,358,0.476,0.0,1,590,0.785,1.0,1,660,0.878,1.0,1,722,0.96,1.0,1,745,0.991,1.0,1,751,0.999,1.0,1,751,0.999,1.0
291,334,2,754,0,358,0.475,0.0,0,590,0.782,0.0,0,660,0.875,0.0,0,722,0.958,0.0,0,745,0.988,0.0,2,753,0.999,1.0,2,753,0.999,1.0
292,335,2,756,0,358,0.474,0.0,2,592,0.783,1.0,2,662,0.876,1.0,2,724,0.958,1.0,2,747,0.988,1.0,2,755,0.999,1.0,2,755,0.999,1.0
293,336,5,761,0,358,0.47,0.0,2,594,0.781,0.4,4,666,0.875,0.8,5,729,0.958,1.0,5,752,0.988,1.0,5,760,0.999,1.0,5,760,0.999,1.0
294,337,2,763,0,358,0.469,0.0,0,594,0.779,0.0,1,667,0.874,0.5,1,730,0.957,0.5,2,754,0.988,1.0,2,762,0.999,1.0,2,762,0.999,1.0
295,338,2,765,1,359,0.469,0.5,1,595,0.778,0.5,1,668,0.873,0.5,2,732,0.957,1.0,2,756,0.988,1.0,2,764,0.999,1.0,2,764,0.999,1.0
296,340,1,766,0,359,0.469,0.0,1,596,0.778,1.0,1,669,0.873,1.0,1,733,0.957,1.0,1,757,0.988,1.0,1,765,0.999,1.0,1,765,0.999,1.0
297,341,2,768,0,359,0.467,0.0,1,597,0.777,0.5,2,671,0.874,1.0,2,735,0.957,1.0,2,759,0.988,1.0,2,767,0.999,1.0,2,767,0.999,1.0
298,342,1,769,0,359,0.467,0.0,1,598,0.778,1.0,1,672,0.874,1.0,1,736,0.957,1.0,1,760,0.988,1.0,1,768,0.999,1.0,1,768,0.999,1.0
299,343,2,771,0,359,0.466,0.0,1,599,0.777,0.5,1,673,0.873,0.5,2,738,0.957,1.0,2,762,0.988,1.0,2,770,0.999,1.0,2,770,0.999,1.0
300,344,3,774,1,360,0.465,0.333,2,601,0.776,0.667,3,676,0.873,1.0,3,741,0.957,1.0,3,765,0.988,1.0,3,773,0.999,1.0,3,773,0.999,1.0
301,346,5,779,2,362,0.465,0.4,3,604,0.775,0.6,3,679,0.872,0.6,3,744,0.955,0.6,5,770,0.988,1.0,5,778,0.999,1.0,5,778,0.999,1.0
302,347,3,782,0,362,0.463,0.0,1,605,0.774,0.333,1,680,0.87,0.333,2,746,0.954,0.667,3,773,0.988,1.0,3,781,0.999,1.0,3,781,0.999,1.0
303,348,3,785,0,362,0.461,0.0,1,606,0.772,0.333,2,682,0.869,0.667,2,748,0.953,0.667,2,775,0.987,0.667,2,783,0.997,0.667,3,784,0.999,1.0
304,349,2,787,1,363,0.461,0.5,1,607,0.771,0.5,1,683,0.868,0.5,2,750,0.953,1.0,2,777,0.987,1.0,2,785,0.997,1.0,2,786,0.999,1.0
305,350,1,788,0,363,0.461,0.0,1,608,0.772,1.0,1,684,0.868,1.0,1,751,0.953,1.0,1,778,0.987,1.0,1,786,0.997,1.0,1,787,0.999,1.0
306,352,2,790,1,364,0.461,0.5,1,609,0.771,0.5,1,685,0.867,0.5,1,752,0.952,0.5,2,780,0.987,1.0,2,788,0.997,1.0,2,789,0.999,1.0
307,353,1,791,1,365,0.461,1.0,1,610,0.771,1.0,1,686,0.867,1.0,1,753,0.952,1.0,1,781,0.987,1.0,1,789,0.997,1.0,1,790,0.999,1.0
308,354,1,792,0,365,0.461,0.0,1,611,0.771,1.0,1,687,0.867,1.0,1,754,0.952,1.0,1,782,0.987,1.0,1,790,0.997,1.0,1,791,0.999,1.0
309,355,3,795,1,366,0.46,0.333,2,613,0.771,0.667,2,689,0.867,0.667,3,757,0.952,1.0,3,785,0.987,1.0,3,793,0.997,1.0,3,794,0.999,1.0
310,356,3,798,0,366,0.459,0.0,1,614,0.769,0.333,2,691,0.866,0.667,3,760,0.952,1.0,3,788,0.987,1.0,3,796,0.997,1.0,3,797,0.999,1.0
311,357,1,799,0,366,0.458,0.0,1,615,0.77,1.0,1,692,0.866,1.0,1,761,0.952,1.0,1,789,0.987,1.0,1,797,0.997,1.0,1,798,0.999,1.0
312,359,4,803,1,367,0.457,0.25,3,618,0.77,0.75,3,695,0.866,0.75,4,765,0.953,1.0,4,793,0.988,1.0,4,801,0.998,1.0,4,802,0.999,1.0
313,360,2,805,1,368,0.457,0.5,2,620,0.77,1.0,2,697,0.866,1.0,2,767,0.953,1.0,2,795,0.988,1.0,2,803,0.998,1.0,2,804,0.999,1.0
314,361,2,807,0,368,0.456,0.0,0,620,0.768,0.0,2,699,0.866,1.0,2,769,0.953,1.0,2,797,0.988,1.0,2,805,0.998,1.0,2,806,0.999,1.0
315,362,2,809,0,368,0.455,0.0,1,621,0.768,0.5,1,700,0.865,0.5,2,771,0.953,1.0,2,799,0.988,1.0,2,807,0.998,1.0,2,808,0.999,1.0
316,364,1,810,0,368,0.454,0.0,0,621,0.767,0.0,0,700,0.864,0.0,1,772,0.953,1.0,1,800,0.988,1.0,1,808,0.998,1.0,1,809,0.999,1.0
317,365,1,811,0,368,0.454,0.0,1,622,0.767,1.0,1,701,0.864,1.0,1,773,0.953,1.0,1,801,0.988,1.0,1,809,0.998,1.0,1,810,0.999,1.0
318,366,1,812,0,368,0.453,0.0,0,622,0.766,0.0,0,701,0.863,0.0,1,774,0.953,1.0,1,802,0.988,1.0,1,810,0.998,1.0,1,811,0.999,1.0
319,367,4,816,1,369,0.452,0.25,4,626,0.767,1.0,4,705,0.864,1.0,4,778,0.953,1.0,4,806,0.988,1.0,4,814,0.998,1.0,4,815,0.999,1.0
320,368,1,817,0,369,0.452,0.0,1,627,0.767,1.0,1,706,0.864,1.0,1,779,0.953,1.0,1,807,0.988,1.0,1,815,0.998,1.0,1,816,0.999,1.0
321,369,3,820,1,370,0.451,0.333,2,629,0.767,0.667,3,709,0.865,1.0,3,782,0.954,1.0,3,810,0.988,1.0,3,818,0.998,1.0,3,819,0.999,1.0
322,372,1,821,1,371,0.452,1.0,1,630,0.767,1.0,1,710,0.865,1.0,1,783,0.954,1.0,1,811,0.988,1.0,1,819,0.998,1.0,1,820,0.999,1.0
323,373,2,823,0,371,0.451,0.0,1,631,0.767,0.5,1,711,0.864,0.5,1,784,0.953,0.5,2,813,0.988,1.0,2,821,0.998,1.0,2,822,0.999,1.0
324,374,2,825,2,373,0.452,1.0,2,633,0.767,1.0,2,713,0.864,1.0,2,786,0.953,1.0,2,815,0.988,1.0,2,823,0.998,1.0,2,824,0.999,1.0
325,375,2,827,0,373,0.451,0.0,1,634,0.767,0.5,1,714,0.863,0.5,2,788,0.953,1.0,2,817,0.988,1.0,2,825,0.998,1.0,2,826,0.999,1.0
326,376,5,832,3,376,0.452,0.6,3,637,0.766,0.6,3,717,0.862,0.6,5,793,0.953,1.0,5,822,0.988,1.0,5,830,0.998,1.0,5,831,0.999,1.0
327,377,1,833,0,376,0.451,0.0,0,637,0.765,0.0,1,718,0.862,1.0,1,794,0.953,1.0,1,823,0.988,1.0,1,831,0.998,1.0,1,832,0.999,1.0
328,378,4,837,2,378,0.452,0.5,4,641,0.766,1.0,4,722,0.863,1.0,4,798,0.953,1.0,4,827,0.988,1.0,4,835,0.998,1.0,4,836,0.999,1.0
329,379,2,839,1,379,0.452,0.5,2,643,0.766,1.0,2,724,0.863,1.0,2,800,0.954,1.0,2,829,0.988,1.0,2,837,0.998,1.0,2,838,0.999,1.0
330,380,1,840,0,379,0.451,0.0,0,643,0.765,0.0,0,724,0.862,0.0,0,800,0.952,0.0,1,830,0.988,1.0,1,838,0.998,1.0,1,839,0.999,1.0
331,381,3,843,0,379,0.45,0.0,1,644,0.764,0.333,3,727,0.862,1.0,3,803,0.953,1.0,3,833,0.988,1.0,3,841,0.998,1.0,3,842,0.999,1.0
332,382,2,845,1,380,0.45,0.5,2,646,0.764,1.0,2,729,0.863,1.0,2,805,0.953,1.0,2,835,0.988,1.0,2,843,0.998,1.0,2,844,0.999,1.0
333,383,4,849,1,381,0.449,0.25,1,647,0.762,0.25,2,731,0.861,0.5,2,807,0.951,0.5,3,838,0.987,0.75,4,847,0.998,1.0,4,848,0.999,1.0
334,385,1,850,0,381,0.448,0.0,1,648,0.762,1.0,1,732,0.861,1.0,1,808,0.951,1.0,1,839,0.987,1.0,1,848,0.998,1.0,1,849,0.999,1.0
335,386,3,853,1,382,0.448,0.333,2,650,0.762,0.667,2,734,0.86,0.667,2,810,0.95,0.667,3,842,0.987,1.0,3,851,0.998,1.0,3,852,0.999,1.0
336,387,1,854,0,382,0.447,0.0,1,651,0.762,1.0,1,735,0.861,1.0,1,811,0.95,1.0,1,843,0.987,1.0,1,852,0.998,1.0,1,853,0.999,1.0
337,389,2,856,1,383,0.447,0.5,1,652,0.762,0.5,2,737,0.861,1.0,2,813,0.95,1.0,2,845,0.987,1.0,2,854,0.998,1.0,2,855,0.999,1.0
338,390,2,858,1,384,0.448,0.5,1,653,0.761,0.5,1,738,0.86,0.5,2,815,0.95,1.0,2,847,0.987,1.0,2,856,0.998,1.0,2,857,0.999,1.0
339,391,4,862,3,387,0.449,0.75,3,656,0.761,0.75,3,741,0.86,0.75,4,819,0.95,1.0,4,851,0.987,1.0,4,860,0.998,1.0,4,861,0.999,1.0
340,392,1,863,0,387,0.448,0.0,0,656,0.76,0.0,0,741,0.859,0.0,1,820,0.95,1.0,1,852,0.987,1.0,1,861,0.998,1.0,1,862,0.999,1.0
341,393,1,864,0,387,0.448,0.0,1,657,0.76,1.0,1,742,0.859,1.0,1,821,0.95,1.0,1,853,0.987,1.0,1,862,0.998,1.0,1,863,0.999,1.0
342,394,5,869,2,389,0.448,0.4,3,660,0.759,0.6,3,745,0.857,0.6,4,825,0.949,0.8,5,858,0.987,1.0,5,867,0.998,1.0,5,868,0.999,1.0
343,395,2,871,1,390,0.448,0.5,2,662,0.76,1.0,2,747,0.858,1.0,2,827,0.949,1.0,2,860,0.987,1.0,2,869,0.998,1.0,2,870,0.999,1.0
344,396,2,873,0,390,0.447,0.0,0,662,0.758,0.0,1,748,0.857,0.5,2,829,0.95,1.0,2,862,0.987,1.0,2,871,0.998,1.0,2,872,0.999,1.0
345,397,3,876,0,390,0.445,0.0,1,663,0.757,0.333,1,749,0.855,0.333,1,830,0.947,0.333,3,865,0.987,1.0,3,874,0.998,1.0,3,875,0.999,1.0
346,398,2,878,0,390,0.444,0.0,0,663,0.755,0.0,1,750,0.854,0.5,2,832,0.948,1.0,2,867,0.987,1.0,2,876,0.998,1.0,2,877,0.999,1.0
347,399,1,879,1,391,0.445,1.0,1,664,0.755,1.0,1,751,0.854,1.0,1,833,0.948,1.0,1,868,0.987,1.0,1,877,0.998,1.0,1,878,0.999,1.0
348,400,3,882,0,391,0.443,0.0,0,664,0.753,0.0,0,751,0.851,0.0,3,836,0.948,1.0,3,871,0.988,1.0,3,880,0.998,1.0,3,881,0.999,1.0
349,401,2,884,1,392,0.443,0.5,1,665,0.752,0.5,2,753,0.852,1.0,2,838,0.948,1.0,2,873,0.988,1.0,2,882,0.998,1.0,2,883,0.999,1.0
350,402,2,886,0,392,0.442,0.0,1,666,0.752,0.5,1,754,0.851,0.5,1,839,0.947,0.5,2,875,0.988,1.0,2,884,0.998,1.0,2,885,0.999,1.0
351,403,5,891,2,394,0.442,0.4,2,668,0.75,0.4,2,756,0.848,0.4,5,844,0.947,1.0,5,880,0.988,1.0,5,889,0.998,1.0,5,890,0.999,1.0
352,404,3,894,1,395,0.442,0.333,2,670,0.749,0.667,3,759,0.849,1.0,3,847,0.947,1.0,3,883,0.988,1.0,3,892,0.998,1.0,3,893,0.999,1.0
353,407,1,895,0,395,0.441,0.0,1,671,0.75,1.0,1,760,0.849,1.0,1,848,0.947,1.0,1,884,0.988,1.0,1,893,0.998,1.0,1,894,0.999,1.0
354,408,4,899,2,397,0.442,0.5,2,673,0.749,0.5,4,764,0.85,1.0,4,852,0.948,1.0,4,888,0.988,1.0,4,897,0.998,1.0,4,898,0.999,1.0
355,410,2,901,1,398,0.442,0.5,2,675,0.749,1.0,2,766,0.85,1.0,2,854,0.948,1.0,2,890,0.988,1.0,2,899,0.998,1.0,2,900,0.999,1.0
356,411,3,904,0,398,0.44,0.0,2,677,0.749,0.667,3,769,0.851,1.0,3,857,0.948,1.0,3,893,0.988,1.0,3,902,0.998,1.0,3,903,0.999,1.0
357,412,1,905,0,398,0.44,0.0,0,677,0.748,0.0,0,769,0.85,0.0,1,858,0.948,1.0,1,894,0.988,1.0,1,903,0.998,1.0,1,904,0.999,1.0
358,413,1,906,1,399,0.44,1.0,1,678,0.748,1.0,1,770,0.85,1.0,1,859,0.948,1.0,1,895,0.988,1.0,1,904,0.998,1.0,1,905,0.999,1.0
359,414,2,908,0,399,0.439,0.0,0,678,0.747,0.0,1,771,0.849,0.5,1,860,0.947,0.5,2,897,0.988,1.0,2,906,0.998,1.0,2,907,0.999,1.0
360,415,3,911,1,400,0.439,0.333,2,680,0.746,0.667,2,773,0.849,0.667,3,863,0.947,1.0,3,900,0.988,1.0,3,909,0.998,1.0,3,910,0.999,1.0
361,416,3,914,1,401,0.439,0.333,1,681,0.745,0.333,2,775,0.848,0.667,2,865,0.946,0.667,2,902,0.987,0.667,3,912,0.998,1.0,3,913,0.999,1.0
362,417,1,915,1,402,0.439,1.0,1,682,0.745,1.0,1,776,0.848,1.0,1,866,0.946,1.0,1,903,0.987,1.0,1,913,0.998,1.0,1,914,0.999,1.0
363,418,1,916,0,402,0.439,0.0,0,682,0.745,0.0,1,777,0.848,1.0,1,867,0.947,1.0,1,904,0.987,1.0,1,914,0.998,1.0,1,915,0.999,1.0
364,420,4,920,1,403,0.438,0.25,2,684,0.743,0.5,2,779,0.847,0.5,4,871,0.947,1.0,4,908,0.987,1.0,4,918,0.998,1.0,4,919,0.999,1.0
365,421,1,921,0,403,0.438,0.0,1,685,0.744,1.0,1,780,0.847,1.0,1,872,0.947,1.0,1,909,0.987,1.0,1,919,0.998,1.0,1,920,0.999,1.0
366,422,3,924,1,404,0.437,0.333,3,688,0.745,1.0,3,783,0.847,1.0,3,875,0.947,1.0,3,912,0.987,1.0,3,922,0.998,1.0,3,923,0.999,1.0
367,423,1,925,0,404,0.437,0.0,1,689,0.745,1.0,1,784,0.848,1.0,1,876,0.947,1.0,1,913,0.987,1.0,1,923,0.998,1.0,1,924,0.999,1.0
368,424,2,927,1,405,0.437,0.5,1,690,0.744,0.5,1,785,0.847,0.5,2,878,0.947,1.0,2,915,0.987,1.0,2,925,0.998,1.0,2,926,0.999,1.0
369,425,5,932,0,405,0.435,0.0,0,690,0.74,0.0,1,786,0.843,0.2,3,881,0.945,0.6,5,920,0.987,1.0,5,930,0.998,1.0,5,931,0.999,1.0
370,426,1,933,0,405,0.434,0.0,0,690,0.74,0.0,0,786,0.842,0.0,0,881,0.944,0.0,1,921,0.987,1.0,1,931,0.998,1.0,1,932,0.999,1.0
371,427,2,935,1,406,0.434,0.5,2,692,0.74,1.0,2,788,0.843,1.0,2,883,0.944,1.0,2,923,0.987,1.0,2,933,0.998,1.0,2,934,0.999,1.0
372,429,3,938,0,406,0.433,0.0,1,693,0.739,0.333,1,789,0.841,0.333,3,886,0.945,1.0,3,926,0.987,1.0,3,936,0.998,1.0,3,937,0.999,1.0
373,430,3,941,2,408,0.434,0.667,2,695,0.739,0.667,2,791,0.841,0.667,3,889,0.945,1.0,3,929,0.987,1.0,3,939,0.998,1.0,3,940,0.999,1.0
374,431,2,943,0,408,0.433,0.0,1,696,0.738,0.5,1,792,0.84,0.5,2,891,0.945,1.0,2,931,0.987,1.0,2,941,0.998,1.0,2,942,0.999,1.0
375,432,1,944,0,408,0.432,0.0,0,696,0.737,0.0,0,792,0.839,0.0,1,892,0.945,1.0,1,932,0.987,1.0,1,942,0.998,1.0,1,943,0.999,1.0
376,436,4,948,1,409,0.431,0.25,2,698,0.736,0.5,3,795,0.839,0.75,3,895,0.944,0.75,4,936,0.987,1.0,4,946,0.998,1.0,4,947,0.999,1.0
377,438,4,952,0,409,0.43,0.0,2,700,0.735,0.5,2,797,0.837,0.5,2,897,0.942,0.5,4,940,0.987,1.0,4,950,0.998,1.0,4,951,0.999,1.0
378,439,4,956,0,409,0.428,0.0,0,700,0.732,0.0,1,798,0.835,0.25,2,899,0.94,0.5,4,944,0.987,1.0,4,954,0.998,1.0,4,955,0.999,1.0
379,440,1,957,1,410,0.428,1.0,1,701,0.732,1.0,1,799,0.835,1.0,1,900,0.94,1.0,1,945,0.987,1.0,1,955,0.998,1.0,1,956,0.999,1.0
380,442,2,959,1,411,0.429,0.5,2,703,0.733,1.0,2,801,0.835,1.0,2,902,0.941,1.0,2,947,0.987,1.0,2,957,0.998,1.0,2,958,0.999,1.0
381,443,1,960,1,412,0.429,1.0,1,704,0.733,1.0,1,802,0.835,1.0,1,903,0.941,1.0,1,948,0.988,1.0,1,958,0.998,1.0,1,959,0.999,1.0
382,444,3,963,2,414,0.43,0.667,2,706,0.733,0.667,2,804,0.835,0.667,3,906,0.941,1.0,3,951,0.988,1.0,3,961,0.998,1.0,3,962,0.999,1.0
383,446,2,965,0,414,0.429,0.0,1,707,0.733,0.5,2,806,0.835,1.0,2,908,0.941,1.0,2,953,0.988,1.0,2,963,0.998,1.0,2,964,0.999,1.0
384,447,2,967,1,415,0.429,0.5,2,709,0.733,1.0,2,808,0.836,1.0,2,910,0.941,1.0,2,955,0.988,1.0,2,965,0.998,1.0,2,966,0.999,1.0
385,448,4,971,1,416,0.428,0.25,2,711,0.732,0.5,2,810,0.834,0.5,4,914,0.941,1.0,4,959,0.988,1.0,4,969,0.998,1.0,4,970,0.999,1.0
386,449,4,975,0,416,0.427,0.0,2,713,0.731,0.5,2,812,0.833,0.5,3,917,0.941,0.75,4,963,0.988,1.0,4,973,0.998,1.0,4,974,0.999,1.0
387,451,3,978,2,418,0.427,0.667,3,716,0.732,1.0,3,815,0.833,1.0,3,920,0.941,1.0,3,966,0.988,1.0,3,976,0.998,1.0,3,977,0.999,1.0
388,452,2,980,0,418,0.427,0.0,1,717,0.732,0.5,1,816,0.833,0.5,2,922,0.941,1.0,2,968,0.988,1.0,2,978,0.998,1.0,2,979,0.999,1.0
389,453,2,982,1,419,0.427,0.5,1,718,0.731,0.5,2,818,0.833,1.0,2,924,0.941,1.0,2,970,0.988,1.0,2,980,0.998,1.0,2,981,0.999,1.0
390,454,1,983,0,419,0.426,0.0,1,719,0.731,1.0,1,819,0.833,1.0,1,925,0.941,1.0,1,971,0.988,1.0,1,981,0.998,1.0,1,982,0.999,1.0
391,455,3,986,1,420,0.426,0.333,1,720,0.73,0.333,2,821,0.833,0.667,2,927,0.94,0.667,3,974,0.988,1.0,3,984,0.998,1.0,3,985,0.999,1.0
392,456,2,988,0,420,0.425,0.0,1,721,0.73,0.5,1,822,0.832,0.5,2,929,0.94,1.0,2,976,0.988,1.0,2,986,0.998,1.0,2,987,0.999,1.0
393,457,1,989,0,420,0.425,0.0,0,721,0.729,0.0,1,823,0.832,1.0,1,930,0.94,1.0,1,977,0.988,1.0,1,987,0.998,1.0,1,988,0.999,1.0
394,458,1,990,0,420,0.424,0.0,0,721,0.728,0.0,0,823,0.831,0.0,1,931,0.94,1.0,1,978,0.988,1.0,1,988,0.998,1.0,1,989,0.999,1.0
395,459,2,992,0,420,0.423,0.0,1,722,0.728,0.5,1,824,0.831,0.5,2,933,0.941,1.0,2,980,0.988,1.0,2,990,0.998,1.0,2,991,0.999,1.0
396,460,1,993,1,421,0.424,1.0,1,723,0.728,1.0,1,825,0.831,1.0,1,934,0.941,1.0,1,981,0.988,1.0,1,991,0.998,1.0,1,992,0.999,1.0
397,462,1,994,0,421,0.424,0.0,1,724,0.728,1.0,1,826,0.831,1.0,1,935,0.941,1.0,1,982,0.988,1.0,1,992,0.998,1.0,1,993,0.999,1.0
398,463,2,996,1,422,0.424,0.5,2,726,0.729,1.0,2,828,0.831,1.0,2,937,0.941,1.0,2,984,0.988,1.0,2,994,0.998,1.0,2,995,0.999,1.0
399,464,4,1000,3,425,0.425,0.75,3,729,0.729,0.75,3,831,0.831,0.75,4,941,0.941,1.0,4,988,0.988,1.0,4,998,0.998,1.0,4,999,0.999,1.0
400,465,1,1001,0,425,0.425,0.0,1,730,0.729,1.0,1,832,0.831,1.0,1,942,0.941,1.0,1,989,0.988,1.0,1,999,0.998,1.0,1,1000,0.999,1.0
401,466,1,1002,0,425,0.424,0.0,1,731,0.73,1.0,1,833,0.831,1.0,1,943,0.941,1.0,1,990,0.988,1.0,1,1000,0.998,1.0,1,1001,0.999,1.0
402,467,1,1003,0,425,0.424,0.0,1,732,0.73,1.0,1,834,0.832,1.0,1,944,0.941,1.0,1,991,0.988,1.0,1,1001,0.998,1.0,1,1002,0.999,1.0
403,468,3,1006,1,426,0.423,0.333,2,734,0.73,0.667,2,836,0.831,0.667,3,947,0.941,1.0,3,994,0.988,1.0,3,1004,0.998,1.0,3,1005,0.999,1.0
404,469,1,1007,0,426,0.423,0.0,0,734,0.729,0.0,0,836,0.83,0.0,1,948,0.941,1.0,1,995,0.988,1.0,1,1005,0.998,1.0,1,1006,0.999,1.0
405,470,2,1009,0,426,0.422,0.0,2,736,0.729,1.0,2,838,0.831,1.0,2,950,0.942,1.0,2,997,0.988,1.0,2,1007,0.998,1.0,2,1008,0.999,1.0
406,471,1,1010,0,426,0.422,0.0,1,737,0.73,1.0,1,839,0.831,1.0,1,951,0.942,1.0,1,998,0.988,1.0,1,1008,0.998,1.0,1,1009,0.999,1.0
407,472,4,1014,1,427,0.421,0.25,3,740,0.73,0.75,3,842,0.83,0.75,3,954,0.941,0.75,4,1002,0.988,1.0,4,1012,0.998,1.0,4,1013,0.999,1.0
408,473,2,1016,0,427,0.42,0.0,1,741,0.729,0.5,2,844,0.831,1.0,2,956,0.941,1.0,2,1004,0.988,1.0,2,1014,0.998,1.0,2,1015,0.999,1.0
409,474,3,1019,0,427,0.419,0.0,1,742,0.728,0.333,2,846,0.83,0.667,2,958,0.94,0.667,3,1007,0.988,1.0,3,1017,0.998,1.0,3,1018,0.999,1.0
410,475,1,1020,0,427,0.419,0.0,0,742,0.727,0.0,0,846,0.829,0.0,0,958,0.939,0.0,1,1008,0.988,1.0,1,1018,0.998,1.0,1,1019,0.999,1.0
411,476,1,1021,0,427,0.418,0.0,0,742,0.727,0.0,1,847,0.83,1.0,1,959,0.939,1.0,1,1009,0.988,1.0,1,1019,0.998,1.0,1,1020,0.999,1.0
412,477,4,1025,0,427,0.417,0.0,0,742,0.724,0.0,0,847,0.826,0.0,3,962,0.939,0.75,4,1013,0.988,1.0,4,1023,0.998,1.0,4,1024,0.999,1.0
413,479,3,1028,0,427,0.415,0.0,1,743,0.723,0.333,3,850,0.827,1.0,3,965,0.939,1.0,3,1016,0.988,1.0,3,1026,0.998,1.0,3,1027,0.999,1.0
414,480,1,1029,0,427,0.415,0.0,1,744,0.723,1.0,1,851,0.827,1.0,1,966,0.939,1.0,1,1017,0.988,1.0,1,1027,0.998,1.0,1,1028,0.999,1.0
415,481,2,1031,0,427,0.414,0.0,1,745,0.723,0.5,1,852,0.826,0.5,2,968,0.939,1.0,2,1019,0.988,1.0,2,1029,0.998,1.0,2,1030,0.999,1.0
416,482,2,1033,0,427,0.413,0.0,0,745,0.721,0.0,1,853,0.826,0.5,2,970,0.939,1.0,2,1021,0.988,1.0,2,1031,0.998,1.0,2,1032,0.999,1.0
417,483,1,1034,1,428,0.414,1.0,1,746,0.721,1.0,1,854,0.826,1.0,1,971,0.939,1.0,1,1022,0.988,1.0,1,1032,0.998,1.0,1,1033,0.999,1.0
418,485,1,1035,0,428,0.414,0.0,1,747,0.722,1.0,1,855,0.826,1.0,1,972,0.939,1.0,1,1023,0.988,1.0,1,1033,0.998,1.0,1,1034,0.999,1.0
419,486,2,1037,0,428,0.413,0.0,0,747,0.72,0.0,1,856,0.825,0.5,2,974,0.939,1.0,2,1025,0.988,1.0,2,1035,0.998,1.0,2,1036,0.999,1.0
420,489,1,1038,0,428,0.412,0.0,0,747,0.72,0.0,0,856,0.825,0.0,1,975,0.939,1.0,1,1026,0.988,1.0,1,1036,0.998,1.0,1,1037,0.999,1.0
421,490,4,1042,0,428,0.411,0.0,4,751,0.721,1.0,4,860,0.825,1.0,4,979,0.94,1.0,4,1030,0.988,1.0,4,1040,0.998,1.0,4,1041,0.999,1.0
422,492,4,1046,2,430,0.411,0.5,3,754,0.721,0.75,4,864,0.826,1.0,4,983,0.94,1.0,4,1034,0.989,1.0,4,1044,0.998,1.0,4,1045,0.999,1.0
423,494,5,1051,2,432,0.411,0.4,2,756,0.719,0.4,3,867,0.825,0.6,4,987,0.939,0.8,4,1038,0.988,0.8,4,1048,0.997,0.8,5,1050,0.999,1.0
424,495,2,1053,0,432,0.41,0.0,1,757,0.719,0.5,1,868,0.824,0.5,1,988,0.938,0.5,2,1040,0.988,1.0,2,1050,0.997,1.0,2,1052,0.999,1.0
425,496,2,1055,0,432,0.409,0.0,1,758,0.718,0.5,2,870,0.825,1.0,2,990,0.938,1.0,2,1042,0.988,1.0,2,1052,0.997,1.0,2,1054,0.999,1.0
426,497,2,1057,1,433,0.41,0.5,1,759,0.718,0.5,2,872,0.825,1.0,2,992,0.939,1.0,2,1044,0.988,1.0,2,1054,0.997,1.0,2,1056,0.999,1.0
427,498,2,1059,0,433,0.409,0.0,1,760,0.718,0.5,1,873,0.824,0.5,2,994,0.939,1.0,2,1046,0.988,1.0,2,1056,0.997,1.0,2,1058,0.999,1.0
428,500,3,1062,1,434,0.409,0.333,1,761,0.717,0.333,3,876,0.825,1.0,3,997,0.939,1.0,3,1049,0.988,1.0,3,1059,0.997,1.0,3,1061,0.999,1.0
429,501,1,1063,0,434,0.408,0.0,0,761,0.716,0.0,0,876,0.824,0.0,1,998,0.939,1.0,1,1050,0.988,1.0,1,1060,0.997,1.0,1,1062,0.999,1.0
430,502,1,1064,0,434,0.408,0.0,1,762,0.716,1.0,1,877,0.824,1.0,1,999,0.939,1.0,1,1051,0.988,1.0,1,1061,0.997,1.0,1,1063,0.999,1.0
431,503,2,1066,0,434,0.407,0.0,0,762,0.715,0.0,0,877,0.823,0.0,1,1000,0.938,0.5,2,1053,0.988,1.0,2,1063,0.997,1.0,2,1065,0.999,1.0
432,504,5,1071,0,434,0.405,0.0,4,766,0.715,0.8,4,881,0.823,0.8,5,1005,0.938,1.0,5,1058,0.988,1.0,5,1068,0.997,1.0,5,1070,0.999,1.0
433,506,2,1073,0,434,0.404,0.0,0,766,0.714,0.0,1,882,0.822,0.5,1,1006,0.938,0.5,2,1060,0.988,1.0,2,1070,0.997,1.0,2,1072,0.999,1.0
434,507,1,1074,0,434,0.404,0.0,0,766,0.713,0.0,0,882,0.821,0.0,1,1007,0.938,1.0,1,1061,0.988,1.0,1,1071,0.997,1.0,1,1073,0.999,1.0
435,508,1,1075,1,435,0.405,1.0,1,767,0.713,1.0,1,883,0.821,1.0,1,1008,0.938,1.0,1,1062,0.988,1.0,1,1072,0.997,1.0,1,1074,0.999,1.0
436,509,1,1076,0,435,0.404,0.0,0,767,0.713,0.0,0,883,0.821,0.0,1,1009,0.938,1.0,1,1063,0.988,1.0,1,1073,0.997,1.0,1,1075,0.999,1.0
437,510,1,1077,0,435,0.404,0.0,0,767,0.712,0.0,0,883,0.82,0.0,1,1010,0.938,1.0,1,1064,0.988,1.0,1,1074,0.997,1.0,1,1076,0.999,1.0
438,511,1,1078,0,435,0.404,0.0,1,768,0.712,1.0,1,884,0.82,1.0,1,1011,0.938,1.0,1,1065,0.988,1.0,1,1075,0.997,1.0,1,1077,0.999,1.0
439,512,1,1079,0,435,0.403,0.0,1,769,0.713,1.0,1,885,0.82,1.0,1,1012,0.938,1.0,1,1066,0.988,1.0,1,1076,0.997,1.0,1,1078,0.999,1.0
440,514,2,1081,1,436,0.403,0.5,1,770,0.712,0.5,1,886,0.82,0.5,2,1014,0.938,1.0,2,1068,0.988,1.0,2,1078,0.997,1.0,2,1080,0.999,1.0
441,515,2,1083,0,436,0.403,0.0,0,770,0.711,0.0,0,886,0.818,0.0,0,1014,0.936,0.0,1,1069,0.987,0.5,1,1079,0.996,0.5,1,1081,0.998,0.5
442,516,4,1087,1,437,0.402,0.25,1,771,0.709,0.25,1,887,0.816,0.25,2,1016,0.935,0.5,2,1071,0.985,0.5,3,1082,0.995,0.75,4,1085,0.998,1.0
443,518,2,1089,1,438,0.402,0.5,2,773,0.71,1.0,2,889,0.816,1.0,2,1018,0.935,1.0,2,1073,0.985,1.0,2,1084,0.995,1.0,2,1087,0.998,1.0
444,520,2,1091,0,438,0.401,0.0,0,773,0.709,0.0,0,889,0.815,0.0,1,1019,0.934,0.5,1,1074,0.984,0.5,2,1086,0.995,1.0,2,1089,0.998,1.0
445,521,4,1095,0,438,0.4,0.0,1,774,0.707,0.25,3,892,0.815,0.75,4,1023,0.934,1.0,4,1078,0.984,1.0,4,1090,0.995,1.0,4,1093,0.998,1.0
446,522,3,1098,2,440,0.401,0.667,2,776,0.707,0.667,2,894,0.814,0.667,3,1026,0.934,1.0,3,1081,0.985,1.0,3,1093,0.995,1.0,3,1096,0.998,1.0
447,523,1,1099,0,440,0.4,0.0,0,776,0.706,0.0,1,895,0.814,1.0,1,1027,0.934,1.0,1,1082,0.985,1.0,1,1094,0.995,1.0,1,1097,0.998,1.0
448,524,1,1100,0,440,0.4,0.0,1,777,0.706,1.0,1,896,0.815,1.0,1,1028,0.935,1.0,1,1083,0.985,1.0,1,1095,0.995,1.0,1,1098,0.998,1.0
449,526,3,1103,1,441,0.4,0.333,2,779,0.706,0.667,2,898,0.814,0.667,3,1031,0.935,1.0,3,1086,0.985,1.0,3,1098,0.995,1.0,3,1101,0.998,1.0
450,527,4,1107,1,442,0.399,0.25,3,782,0.706,0.75,3,901,0.814,0.75,3,1034,0.934,0.75,3,1089,0.984,0.75,3,1101,0.995,0.75,3,1104,0.997,0.75
451,528,1,1108,1,443,0.4,1.0,1,783,0.707,1.0,1,902,0.814,1.0,1,1035,0.934,1.0,1,1090,0.984,1.0,1,1102,0.995,1.0,1,1105,0.997,1.0
452,529,1,1109,0,443,0.399,0.0,1,784,0.707,1.0,1,903,0.814,1.0,1,1036,0.934,1.0,1,1091,0.984,1.0,1,1103,0.995,1.0,1,1106,0.997,1.0
453,530,3,1112,0,443,0.398,0.0,0,784,0.705,0.0,1,904,0.813,0.333,2,1038,0.933,0.667,2,1093,0.983,0.667,2,1105,0.994,0.667,2,1108,0.996,0.667
454,531,3,1115,0,443,0.397,0.0,2,786,0.705,0.667,2,906,0.813,0.667,2,1040,0.933,0.667,2,1095,0.982,0.667,2,1107,0.993,0.667,2,1110,0.996,0.667
455,532,2,1117,1,444,0.397,0.5,1,787,0.705,0.5,1,907,0.812,0.5,2,1042,0.933,1.0,2,1097,0.982,1.0,2,1109,0.993,1.0,2,1112,0.996,1.0
456,534,1,1118,0,444,0.397,0.0,0,787,0.704,0.0,0,907,0.811,0.0,1,1043,0.933,1.0,1,1098,0.982,1.0,1,1110,0.993,1.0,1,1113,0.996,1.0
457,535,2,1120,0,444,0.396,0.0,1,788,0.704,0.5,2,909,0.812,1.0,2,1045,0.933,1.0,2,1100,0.982,1.0,2,1112,0.993,1.0,2,1115,0.996,1.0
458,536,2,1122,0,444,0.396,0.0,0,788,0.702,0.0,1,910,0.811,0.5,1,1046,0.932,0.5,2,1102,0.982,1.0,2,1114,0.993,1.0,2,1117,0.996,1.0
459,537,2,1124,1,445,0.396,0.5,1,789,0.702,0.5,1,911,0.81,0.5,1,1047,0.931,0.5,1,1103,0.981,0.5,2,1116,0.993,1.0,2,1119,0.996,1.0
460,538,1,1125,0,445,0.396,0.0,0,789,0.701,0.0,0,911,0.81,0.0,1,1048,0.932,1.0,1,1104,0.981,1.0,1,1117,0.993,1.0,1,1120,0.996,1.0
461,539,1,1126,0,445,0.395,0.0,0,789,0.701,0.0,1,912,0.81,1.0,1,1049,0.932,1.0,1,1105,0.981,1.0,1,1118,0.993,1.0,1,1121,0.996,1.0
462,540,5,1131,0,445,0.393,0.0,1,790,0.698,0.2,2,914,0.808,0.4,4,1053,0.931,0.8,5,1110,0.981,1.0,5,1123,0.993,1.0,5,1126,0.996,1.0
463,541,2,1133,0,445,0.393,0.0,0,790,0.697,0.0,0,914,0.807,0.0,2,1055,0.931,1.0,2,1112,0.981,1.0,2,1125,0.993,1.0,2,1128,0.996,1.0
464,542,1,1134,0,445,0.392,0.0,0,790,0.697,0.0,0,914,0.806,0.0,0,1055,0.93,0.0,0,1112,0.981,0.0,0,1125,0.992,0.0,1,1129,0.996,1.0
465,543,2,1136,0,445,0.392,0.0,1,791,0.696,0.5,1,915,0.805,0.5,1,1056,0.93,0.5,2,1114,0.981,1.0,2,1127,0.992,1.0,2,1131,0.996,1.0
466,544,3,1139,0,445,0.391,0.0,2,793,0.696,0.667,2,917,0.805,0.667,2,1058,0.929,0.667,2,1116,0.98,0.667,3,1130,0.992,1.0,3,1134,0.996,1.0
467,545,1,1140,0,445,0.39,0.0,1,794,0.696,1.0,1,918,0.805,1.0,1,1059,0.929,1.0,1,1117,0.98,1.0,1,1131,0.992,1.0,1,1135,0.996,1.0
468,546,2,1142,1,446,0.391,0.5,2,796,0.697,1.0,2,920,0.806,1.0,2,1061,0.929,1.0,2,1119,0.98,1.0,2,1133,0.992,1.0,2,1137,0.996,1.0
469,547,3,1145,0,446,0.39,0.0,0,796,0.695,0.0,1,921,0.804,0.333,3,1064,0.929,1.0,3,1122,0.98,1.0,3,1136,0.992,1.0,3,1140,0.996,1.0
470,550,2,1147,0,446,0.389,0.0,0,796,0.694,0.0,0,921,0.803,0.0,2,1066,0.929,1.0,2,1124,0.98,1.0,2,1138,0.992,1.0,2,1142,0.996,1.0
471,552,3,1150,1,447,0.389,0.333,1,797,0.693,0.333,2,923,0.803,0.667,2,1068,0.929,0.667,3,1127,0.98,1.0,3,1141,0.992,1.0,3,1145,0.996,1.0
472,553,1,1151,0,447,0.388,0.0,1,798,0.693,1.0,1,924,0.803,1.0,1,1069,0.929,1.0,1,1128,0.98,1.0,1,1142,0.992,1.0,1,1146,0.996,1.0
473,554,2,1153,0,447,0.388,0.0,1,799,0.693,0.5,1,925,0.802,0.5,2,1071,0.929,1.0,2,1130,0.98,1.0,2,1144,0.992,1.0,2,1148,0.996,1.0
474,556,3,1156,0,447,0.387,0.0,0,799,0.691,0.0,0,925,0.8,0.0,2,1073,0.928,0.667,3,1133,0.98,1.0,3,1147,0.992,1.0,3,1151,0.996,1.0
475,557,2,1158,0,447,0.386,0.0,0,799,0.69,0.0,1,926,0.8,0.5,1,1074,0.927,0.5,2,1135,0.98,1.0,2,1149,0.992,1.0,2,1153,0.996,1.0
476,559,1,1159,0,447,0.386,0.0,1,800,0.69,1.0,1,927,0.8,1.0,1,1075,0.928,1.0,1,1136,0.98,1.0,1,1150,0.992,1.0,1,1154,0.996,1.0
477,560,1,1160,0,447,0.385,0.0,0,800,0.69,0.0,0,927,0.799,0.0,0,1075,0.927,0.0,1,1137,0.98,1.0,1,1151,0.992,1.0,1,1155,0.996,1.0
478,561,1,1161,0,447,0.385,0.0,0,800,0.689,0.0,0,927,0.798,0.0,1,1076,0.927,1.0,1,1138,0.98,1.0,1,1152,0.992,1.0,1,1156,0.996,1.0
479,563,3,1164,0,447,0.384,0.0,0,800,0.687,0.0,0,927,0.796,0.0,3,1079,0.927,1.0,3,1141,0.98,1.0,3,1155,0.992,1.0,3,1159,0.996,1.0
480,564,1,1165,0,447,0.384,0.0,1,801,0.688,1.0,1,928,0.797,1.0,1,1080,0.927,1.0,1,1142,0.98,1.0,1,1156,0.992,1.0,1,1160,0.996,1.0
481,565,3,1168,0,447,0.383,0.0,1,802,0.687,0.333,2,930,0.796,0.667,3,1083,0.927,1.0,3,1145,0.98,1.0,3,1159,0.992,1.0,3,1163,0.996,1.0
482,566,1,1169,0,447,0.382,0.0,0,802,0.686,0.0,0,930,0.796,0.0,0,1083,0.926,0.0,0,1145,0.979,0.0,1,1160,0.992,1.0,1,1164,0.996,1.0
483,568,4,1173,1,448,0.382,0.25,2,804,0.685,0.5,3,933,0.795,0.75,4,1087,0.927,1.0,4,1149,0.98,1.0,4,1164,0.992,1.0,4,1168,0.996,1.0
484,569,1,1174,0,448,0.382,0.0,0,804,0.685,0.0,0,933,0.795,0.0,1,1088,0.927,1.0,1,1150,0.98,1.0,1,1165,0.992,1.0,1,1169,0.996,1.0
485,571,1,1175,1,449,0.382,1.0,1,805,0.685,1.0,1,934,0.795,1.0,1,1089,0.927,1.0,1,1151,0.98,1.0,1,1166,0.992,1.0,1,1170,0.996,1.0
486,574,1,1176,0,449,0.382,0.0,1,806,0.685,1.0,1,935,0.795,1.0,1,1090,0.927,1.0,1,1152,0.98,1.0,1,1167,0.992,1.0,1,1171,0.996,1.0
487,575,1,1177,0,449,0.381,0.0,1,807,0.686,1.0,1,936,0.795,1.0,1,1091,0.927,1.0,1,1153,0.98,1.0,1,1168,0.992,1.0,1,1172,0.996,1.0
488,577,4,1181,0,449,0.38,0.0,1,808,0.684,0.25,3,939,0.795,0.75,3,1094,0.926,0.75,4,1157,0.98,1.0,4,1172,0.992,1.0,4,1176,0.996,1.0
489,578,2,1183,0,449,0.38,0.0,1,809,0.684,0.5,1,940,0.795,0.5,2,1096,0.926,1.0,2,1159,0.98,1.0,2,1174,0.992,1.0,2,1178,0.996,1.0
490,579,1,1184,1,450,0.38,1.0,1,810,0.684,1.0,1,941,0.795,1.0,1,1097,0.927,1.0,1,1160,0.98,1.0,1,1175,0.992,1.0,1,1179,0.996,1.0
491,580,1,1185,0,450,0.38,0.0,1,811,0.684,1.0,1,942,0.795,1.0,1,1098,0.927,1.0,1,1161,0.98,1.0,1,1176,0.992,1.0,1,1180,0.996,1.0
492,582,1,1186,0,450,0.379,0.0,0,811,0.684,0.0,0,942,0.794,0.0,0,1098,0.926,0.0,1,1162,0.98,1.0,1,1177,0.992,1.0,1,1181,0.996,1.0
493,583,1,1187,0,450,0.379,0.0,1,812,0.684,1.0,1,943,0.794,1.0,1,1099,0.926,1.0,1,1163,0.98,1.0,1,1178,0.992,1.0,1,1182,0.996,1.0
494,584,1,1188,0,450,0.379,0.0,0,812,0.684,0.0,0,943,0.794,0.0,0,1099,0.925,0.0,1,1164,0.98,1.0,1,1179,0.992,1.0,1,1183,0.996,1.0
495,585,3,1191,0,450,0.378,0.0,1,813,0.683,0.333,2,945,0.793,0.667,3,1102,0.925,1.0,3,1167,0.98,1.0,3,1182,0.992,1.0,3,1186,0.996,1.0
496,590,1,1192,0,450,0.378,0.0,0,813,0.682,0.0,0,945,0.793,0.0,1,1103,0.925,1.0,1,1168,0.98,1.0,1,1183,0.992,1.0,1,1187,0.996,1.0
497,591,1,1193,1,451,0.378,1.0,1,814,0.682,1.0,1,946,0.793,1.0,1,1104,0.925,1.0,1,1169,0.98,1.0,1,1184,0.992,1.0,1,1188,0.996,1.0
498,592,1,1194,0,451,0.378,0.0,0,814,0.682,0.0,0,946,0.792,0.0,1,1105,0.925,1.0,1,1170,0.98,1.0,1,1185,0.992,1.0,1,1189,0.996,1.0
499,594,1,1195,0,451,0.377,0.0,0,814,0.681,0.0,0,946,0.792,0.0,1,1106,0.926,1.0,1,1171,0.98,1.0,1,1186,0.992,1.0,1,1190,0.996,1.0
500,595,1,1196,0,451,0.377,0.0,1,815,0.681,1.0,1,947,0.792,1.0,1,1107,0.926,1.0,1,1172,0.98,1.0,1,1187,0.992,1.0,1,1191,0.996,1.0
501,596,3,1199,0,451,0.376,0.0,0,815,0.68,0.0,1,948,0.791,0.333,1,1108,0.924,0.333,2,1174,0.979,0.667,3,1190,0.992,1.0,3,1194,0.996,1.0
502,599,2,1201,0,451,0.376,0.0,1,816,0.679,0.5,2,950,0.791,1.0,2,1110,0.924,1.0,2,1176,0.979,1.0,2,1192,0.993,1.0,2,1196,0.996,1.0
503,600,1,1202,0,451,0.375,0.0,0,816,0.679,0.0,1,951,0.791,1.0,1,1111,0.924,1.0,1,1177,0.979,1.0,1,1193,0.993,1.0,1,1197,0.996,1.0
504,601,1,1203,1,452,0.376,1.0,1,817,0.679,1.0,1,952,0.791,1.0,1,1112,0.924,1.0,1,1178,0.979,1.0,1,1194,0.993,1.0,1,1198,0.996,1.0
505,602,3,1206,0,452,0.375,0.0,0,817,0.677,0.0,0,952,0.789,0.0,1,1113,0.923,0.333,2,1180,0.978,0.667,3,1197,0.993,1.0,3,1201,0.996,1.0
506,603,1,1207,1,453,0.375,1.0,1,818,0.678,1.0,1,953,0.79,1.0,1,1114,0.923,1.0,1,1181,0.978,1.0,1,1198,0.993,1.0,1,1202,0.996,1.0
507,604,2,1209,0,453,0.375,0.0,1,819,0.677,0.5,1,954,0.789,0.5,2,1116,0.923,1.0,2,1183,0.978,1.0,2,1200,0.993,1.0,2,1204,0.996,1.0
508,605,3,1212,0,453,0.374,0.0,1,820,0.677,0.333,2,956,0.789,0.667,2,1118,0.922,0.667,3,1186,0.979,1.0,3,1203,0.993,1.0,3,1207,0.996,1.0
509,606,3,1215,0,453,0.373,0.0,1,821,0.676,0.333,2,958,0.788,0.667,2,1120,0.922,0.667,3,1189,0.979,1.0,3,1206,0.993,1.0,3,1210,0.996,1.0
510,607,2,1217,2,455,0.374,1.0,2,823,0.676,1.0,2,960,0.789,1.0,2,1122,0.922,1.0,2,1191,0.979,1.0,2,1208,0.993,1.0,2,1212,0.996,1.0
511,608,1,1218,0,455,0.374,0.0,1,824,0.677,1.0,1,961,0.789,1.0,1,1123,0.922,1.0,1,1192,0.979,1.0,1,1209,0.993,1.0,1,1213,0.996,1.0
512,609,1,1219,0,455,0.373,0.0,0,824,0.676,0.0,0,961,0.788,0.0,0,1123,0.921,0.0,1,1193,0.979,1.0,1,1210,0.993,1.0,1,1214,0.996,1.0
513,611,1,1220,0,455,0.373,0.0,0,824,0.675,0.0,0,961,0.788,0.0,0,1123,0.92,0.0,0,1193,0.978,0.0,0,1210,0.992,0.0,1,1215,0.996,1.0
514,612,1,1221,1,456,0.373,1.0,1,825,0.676,1.0,1,962,0.788,1.0,1,1124,0.921,1.0,1,1194,0.978,1.0,1,1211,0.992,1.0,1,1216,0.996,1.0
515,613,3,1224,0,456,0.373,0.0,0,825,0.674,0.0,0,962,0.786,0.0,1,1125,0.919,0.333,3,1197,0.978,1.0,3,1214,0.992,1.0,3,1219,0.996,1.0
516,614,2,1226,0,456,0.372,0.0,1,826,0.674,0.5,1,963,0.785,0.5,2,1127,0.919,1.0,2,1199,0.978,1.0,2,1216,0.992,1.0,2,1221,0.996,1.0
517,615,1,1227,0,456,0.372,0.0,0,826,0.673,0.0,0,963,0.785,0.0,0,1127,0.919,0.0,1,1200,0.978,1.0,1,1217,0.992,1.0,1,1222,0.996,1.0
518,617,1,1228,0,456,0.371,0.0,0,826,0.673,0.0,0,963,0.784,0.0,1,1128,0.919,1.0,1,1201,0.978,1.0,1,1218,0.992,1.0,1,1223,0.996,1.0
519,618,2,1230,1,457,0.372,0.5,1,827,0.672,0.5,1,964,0.784,0.5,2,1130,0.919,1.0,2,1203,0.978,1.0,2,1220,0.992,1.0,2,1225,0.996,1.0
520,619,1,1231,0,457,0.371,0.0,0,827,0.672,0.0,1,965,0.784,1.0,1,1131,0.919,1.0,1,1204,0.978,1.0,1,1221,0.992,1.0,1,1226,0.996,1.0
521,620,3,1234,0,457,0.37,0.0,1,828,0.671,0.333,2,967,0.784,0.667,3,1134,0.919,1.0,3,1207,0.978,1.0,3,1224,0.992,1.0,3,1229,0.996,1.0
522,621,1,1235,1,458,0.371,1.0,1,829,0.671,1.0,1,968,0.784,1.0,1,1135,0.919,1.0,1,1208,0.978,1.0,1,1225,0.992,1.0,1,1230,0.996,1.0
523,622,1,1236,0,458,0.371,0.0,1,830,0.672,1.0,1,969,0.784,1.0,1,1136,0.919,1.0,1,1209,0.978,1.0,1,1226,0.992,1.0,1,1231,0.996,1.0
524,625,3,1239,0,458,0.37,0.0,1,831,0.671,0.333,1,970,0.783,0.333,2,1138,0.918,0.667,2,1211,0.977,0.667,3,1229,0.992,1.0,3,1234,0.996,1.0
525,627,1,1240,0,458,0.369,0.0,0,831,0.67,0.0,0,970,0.782,0.0,1,1139,0.919,1.0,1,1212,0.977,1.0,1,1230,0.992,1.0,1,1235,0.996,1.0
526,628,5,1245,2,460,0.369,0.4,3,834,0.67,0.6,3,973,0.782,0.6,5,1144,0.919,1.0,5,1217,0.978,1.0,5,1235,0.992,1.0,5,1240,0.996,1.0
527,629,1,1246,0,460,0.369,0.0,1,835,0.67,1.0,1,974,0.782,1.0,1,1145,0.919,1.0,1,1218,0.978,1.0,1,1236,0.992,1.0,1,1241,0.996,1.0
528,630,2,1248,1,461,0.369,0.5,1,836,0.67,0.5,1,975,0.781,0.5,1,1146,0.918,0.5,2,1220,0.978,1.0,2,1238,0.992,1.0,2,1243,0.996,1.0
529,631,1,1249,1,462,0.37,1.0,1,837,0.67,1.0,1,976,0.781,1.0,1,1147,0.918,1.0,1,1221,0.978,1.0,1,1239,0.992,1.0,1,1244,0.996,1.0
530,633,2,1251,1,463,0.37,0.5,1,838,0.67,0.5,1,977,0.781,0.5,1,1148,0.918,0.5,2,1223,0.978,1.0,2,1241,0.992,1.0,2,1246,0.996,1.0
531,634,2,1253,0,463,0.37,0.0,0,838,0.669,0.0,0,977,0.78,0.0,1,1149,0.917,0.5,2,1225,0.978,1.0,2,1243,0.992,1.0,2,1248,0.996,1.0
532,635,3,1256,0,463,0.369,0.0,0,838,0.667,0.0,2,979,0.779,0.667,2,1151,0.916,0.667,3,1228,0.978,1.0,3,1246,0.992,1.0,3,1251,0.996,1.0
533,637,1,1257,0,463,0.368,0.0,0,838,0.667,0.0,0,979,0.779,0.0,0,1151,0.916,0.0,0,1228,0.977,0.0,1,1247,0.992,1.0,1,1252,0.996,1.0
534,639,1,1258,0,463,0.368,0.0,0,838,0.666,0.0,0,979,0.778,0.0,1,1152,0.916,1.0,1,1229,0.977,1.0,1,1248,0.992,1.0,1,1253,0.996,1.0
535,640,4,1262,2,465,0.368,0.5,3,841,0.666,0.75,3,982,0.778,0.75,4,1156,0.916,1.0,4,1233,0.977,1.0,4,1252,0.992,1.0,4,1257,0.996,1.0
536,641,1,1263,1,466,0.369,1.0,1,842,0.667,1.0,1,983,0.778,1.0,1,1157,0.916,1.0,1,1234,0.977,1.0,1,1253,0.992,1.0,1,1258,0.996,1.0
537,643,1,1264,0,466,0.369,0.0,0,842,0.666,0.0,0,983,0.778,0.0,0,1157,0.915,0.0,1,1235,0.977,1.0,1,1254,0.992,1.0,1,1259,0.996,1.0
538,644,1,1265,0,466,0.368,0.0,0,842,0.666,0.0,0,983,0.777,0.0,0,1157,0.915,0.0,1,1236,0.977,1.0,1,1255,0.992,1.0,1,1260,0.996,1.0
539,646,3,1268,0,466,0.368,0.0,1,843,0.665,0.333,1,984,0.776,0.333,1,1158,0.913,0.333,2,1238,0.976,0.667,3,1258,0.992,1.0,3,1263,0.996,1.0
540,648,2,1270,0,466,0.367,0.0,0,843,0.664,0.0,0,984,0.775,0.0,2,1160,0.913,1.0,2,1240,0.976,1.0,2,1260,0.992,1.0,2,1265,0.996,1.0
541,649,1,1271,1,467,0.367,1.0,1,844,0.664,1.0,1,985,0.775,1.0,1,1161,0.913,1.0,1,1241,0.976,1.0,1,1261,0.992,1.0,1,1266,0.996,1.0
542,650,1,1272,0,467,0.367,0.0,0,844,0.664,0.0,0,985,0.774,0.0,1,1162,0.914,1.0,1,1242,0.976,1.0,1,1262,0.992,1.0,1,1267,0.996,1.0
543,652,2,1274,0,467,0.367,0.0,0,844,0.662,0.0,0,985,0.773,0.0,1,1163,0.913,0.5,1,1243,0.976,0.5,2,1264,0.992,1.0,2,1269,0.996,1.0
544,653,1,1275,0,467,0.366,0.0,0,844,0.662,0.0,0,985,0.773,0.0,0,1163,0.912,0.0,0,1243,0.975,0.0,0,1264,0.991,0.0,0,1269,0.995,0.0
545,655,2,1277,0,467,0.366,0.0,0,844,0.661,0.0,1,986,0.772,0.5,1,1164,0.912,0.5,1,1244,0.974,0.5,2,1266,0.991,1.0,2,1271,0.995,1.0
546,657,1,1278,1,468,0.366,1.0,1,845,0.661,1.0,1,987,0.772,1.0,1,1165,0.912,1.0,1,1245,0.974,1.0,1,1267,0.991,1.0,1,1272,0.995,1.0
547,658,1,1279,0,468,0.366,0.0,0,845,0.661,0.0,1,988,0.772,1.0,1,1166,0.912,1.0,1,1246,0.974,1.0,1,1268,0.991,1.0,1,1273,0.995,1.0
548,659,2,1281,0,468,0.365,0.0,0,845,0.66,0.0,0,988,0.771,0.0,0,1166,0.91,0.0,2,1248,0.974,1.0,2,1270,0.991,1.0,2,1275,0.995,1.0
549,660,4,1285,1,469,0.365,0.25,2,847,0.659,0.5,3,991,0.771,0.75,4,1170,0.911,1.0,4,1252,0.974,1.0,4,1274,0.991,1.0,4,1279,0.995,1.0
550,661,2,1287,1,470,0.365,0.5,1,848,0.659,0.5,1,992,0.771,0.5,2,1172,0.911,1.0,2,1254,0.974,1.0,2,1276,0.991,1.0,2,1281,0.995,1.0
551,663,1,1288,0,470,0.365,0.0,0,848,0.658,0.0,0,992,0.77,0.0,0,1172,0.91,0.0,0,1254,0.974,0.0,0,1276,0.991,0.0,0,1281,0.995,0.0
552,664,1,1289,0,470,0.365,0.0,0,848,0.658,0.0,0,992,0.77,0.0,1,1173,0.91,1.0,1,1255,0.974,1.0,1,1277,0.991,1.0,1,1282,0.995,1.0
553,665,2,1291,0,470,0.364,0.0,1,849,0.658,0.5,1,993,0.769,0.5,1,1174,0.909,0.5,2,1257,0.974,1.0,2,1279,0.991,1.0,2,1284,0.995,1.0
554,666,1,1292,0,470,0.364,0.0,0,849,0.657,0.0,0,993,0.769,0.0,1,1175,0.909,1.0,1,1258,0.974,1.0,1,1280,0.991,1.0,1,1285,0.995,1.0
555,668,1,1293,0,470,0.363,0.0,0,849,0.657,0.0,1,994,0.769,1.0,1,1176,0.91,1.0,1,1259,0.974,1.0,1,1281,0.991,1.0,1,1286,0.995,1.0
556,669,3,1296,1,471,0.363,0.333,1,850,0.656,0.333,1,995,0.768,0.333,2,1178,0.909,0.667,2,1261,0.973,0.667,2,1283,0.99,0.667,2,1288,0.994,0.667
557,674,1,1297,0,471,0.363,0.0,0,850,0.655,0.0,0,995,0.767,0.0,0,1178,0.908,0.0,1,1262,0.973,1.0,1,1284,0.99,1.0,1,1289,0.994,1.0
558,675,1,1298,0,471,0.363,0.0,1,851,0.656,1.0,1,996,0.767,1.0,1,1179,0.908,1.0,1,1263,0.973,1.0,1,1285,0.99,1.0,1,1290,0.994,1.0
559,676,1,1299,0,471,0.363,0.0,0,851,0.655,0.0,0,996,0.767,0.0,0,1179,0.908,0.0,0,1263,0.972,0.0,1,1286,0.99,1.0,1,1291,0.994,1.0
560,677,2,1301,0,471,0.362,0.0,0,851,0.654,0.0,0,996,0.766,0.0,0,1179,0.906,0.0,1,1264,0.972,0.5,2,1288,0.99,1.0,2,1293,0.994,1.0
561,678,4,1305,0,471,0.361,0.0,2,853,0.654,0.5,3,999,0.766,0.75,4,1183,0.907,1.0,4,1268,0.972,1.0,4,1292,0.99,1.0,4,1297,0.994,1.0
562,679,3,1308,1,472,0.361,0.333,2,855,0.654,0.667,2,1001,0.765,0.667,2,1185,0.906,0.667,3,1271,0.972,1.0,3,1295,0.99,1.0,3,1300,0.994,1.0
563,681,1,1309,0,472,0.361,0.0,0,855,0.653,0.0,0,1001,0.765,0.0,0,1185,0.905,0.0,1,1272,0.972,1.0,1,1296,0.99,1.0,1,1301,0.994,1.0
564,683,3,1312,1,473,0.361,0.333,1,856,0.652,0.333,2,1003,0.764,0.667,3,1188,0.905,1.0,3,1275,0.972,1.0,3,1299,0.99,1.0,3,1304,0.994,1.0
565,684,1,1313,0,473,0.36,0.0,0,856,0.652,0.0,0,1003,0.764,0.0,0,1188,0.905,0.0,0,1275,0.971,0.0,0,1299,0.989,0.0,0,1304,0.993,0.0
566,685,1,1314,0,473,0.36,0.0,0,856,0.651,0.0,0,1003,0.763,0.0,0,1188,0.904,0.0,0,1275,0.97,0.0,1,1300,0.989,1.0,1,1305,0.993,1.0
567,686,1,1315,0,473,0.36,0.0,0,856,0.651,0.0,0,1003,0.763,0.0,0,1188,0.903,0.0,0,1275,0.97,0.0,0,1300,0.989,0.0,0,1305,0.992,0.0
568,687,1,1316,0,473,0.359,0.0,0,856,0.65,0.0,0,1003,0.762,0.0,0,1188,0.903,0.0,1,1276,0.97,1.0,1,1301,0.989,1.0,1,1306,0.992,1.0
569,688,3,1319,0,473,0.359,0.0,1,857,0.65,0.333,1,1004,0.761,0.333,1,1189,0.901,0.333,2,1278,0.969,0.667,3,1304,0.989,1.0,3,1309,0.992,1.0
570,690,2,1321,0,473,0.358,0.0,0,857,0.649,0.0,0,1004,0.76,0.0,1,1190,0.901,0.5,1,1279,0.968,0.5,2,1306,0.989,1.0,2,1311,0.992,1.0
571,691,1,1322,1,474,0.359,1.0,1,858,0.649,1.0,1,1005,0.76,1.0,1,1191,0.901,1.0,1,1280,0.968,1.0,1,1307,0.989,1.0,1,1312,0.992,1.0
572,692,3,1325,2,476,0.359,0.667,2,860,0.649,0.667,3,1008,0.761,1.0,3,1194,0.901,1.0,3,1283,0.968,1.0,3,1310,0.989,1.0,3,1315,0.992,1.0
573,693,1,1326,0,476,0.359,0.0,0,860,0.649,0.0,0,1008,0.76,0.0,0,1194,0.9,0.0,1,1284,0.968,1.0,1,1311,0.989,1.0,1,1316,0.992,1.0
574,696,1,1327,0,476,0.359,0.0,0,860,0.648,0.0,0,1008,0.76,0.0,0,1194,0.9,0.0,1,1285,0.968,1.0,1,1312,0.989,1.0,1,1317,0.992,1.0
575,697,3,1330,0,476,0.358,0.0,1,861,0.647,0.333,1,1009,0.759,0.333,3,1197,0.9,1.0,3,1288,0.968,1.0,3,1315,0.989,1.0,3,1320,0.992,1.0
576,699,1,1331,1,477,0.358,1.0,1,862,0.648,1.0,1,1010,0.759,1.0,1,1198,0.9,1.0,1,1289,0.968,1.0,1,1316,0.989,1.0,1,1321,0.992,1.0
577,702,1,1332,0,477,0.358,0.0,0,862,0.647,0.0,0,1010,0.758,0.0,0,1198,0.899,0.0,0,1289,0.968,0.0,1,1317,0.989,1.0,1,1322,0.992,1.0
578,703,1,1333,0,477,0.358,0.0,1,863,0.647,1.0,1,1011,0.758,1.0,1,1199,0.899,1.0,1,1290,0.968,1.0,1,1318,0.989,1.0,1,1323,0.992,1.0
579,704,2,1335,0,477,0.357,0.0,0,863,0.646,0.0,0,1011,0.757,0.0,0,1199,0.898,0.0,1,1291,0.967,0.5,2,1320,0.989,1.0,2,1325,0.993,1.0
580,705,1,1336,0,477,0.357,0.0,0,863,0.646,0.0,0,1011,0.757,0.0,0,1199,0.897,0.0,0,1291,0.966,0.0,0,1320,0.988,0.0,0,1325,0.992,0.0
581,706,1,1337,1,478,0.358,1.0,1,864,0.646,1.0,1,1012,0.757,1.0,1,1200,0.898,1.0,1,1292,0.966,1.0,1,1321,0.988,1.0,1,1326,0.992,1.0
582,707,1,1338,0,478,0.357,0.0,0,864,0.646,0.0,0,1012,0.756,0.0,1,1201,0.898,1.0,1,1293,0.966,1.0,1,1322,0.988,1.0,1,1327,0.992,1.0
583,708,1,1339,0,478,0.357,0.0,1,865,0.646,1.0,1,1013,0.757,1.0,1,1202,0.898,1.0,1,1294,0.966,1.0,1,1323,0.988,1.0,1,1328,0.992,1.0
584,712,2,1341,0,478,0.356,0.0,0,865,0.645,0.0,0,1013,0.755,0.0,1,1203,0.897,0.5,2,1296,0.966,1.0,2,1325,0.988,1.0,2,1330,0.992,1.0
585,715,1,1342,0,478,0.356,0.0,0,865,0.645,0.0,0,1013,0.755,0.0,0,1203,0.896,0.0,1,1297,0.966,1.0,1,1326,0.988,1.0,1,1331,0.992,1.0
586,716,2,1344,0,478,0.356,0.0,2,867,0.645,1.0,2,1015,0.755,1.0,2,1205,0.897,1.0,2,1299,0.967,1.0,2,1328,0.988,1.0,2,1333,0.992,1.0
587,717,3,1347,1,479,0.356,0.333,2,869,0.645,0.667,2,1017,0.755,0.667,3,1208,0.897,1.0,3,1302,0.967,1.0,3,1331,0.988,1.0,3,1336,0.992,1.0
588,718,1,1348,0,479,0.355,0.0,0,869,0.645,0.0,0,1017,0.754,0.0,0,1208,0.896,0.0,1,1303,0.967,1.0,1,1332,0.988,1.0,1,1337,0.992,1.0
589,719,2,1350,0,479,0.355,0.0,0,869,0.644,0.0,0,1017,0.753,0.0,1,1209,0.896,0.5,1,1304,0.966,0.5,2,1334,0.988,1.0,2,1339,0.992,1.0
590,720,2,1352,0,479,0.354,0.0,0,869,0.643,0.0,2,1019,0.754,1.0,2,1211,0.896,1.0,2,1306,0.966,1.0,2,1336,0.988,1.0,2,1341,0.992,1.0
591,721,1,1353,1,480,0.355,1.0,1,870,0.643,1.0,1,1020,0.754,1.0,1,1212,0.896,1.0,1,1307,0.966,1.0,1,1337,0.988,1.0,1,1342,0.992,1.0
592,722,2,1355,0,480,0.354,0.0,0,870,0.642,0.0,0,1020,0.753,0.0,0,1212,0.894,0.0,0,1307,0.965,0.0,1,1338,0.987,0.5,1,1343,0.991,0.5
593,723,4,1359,2,482,0.355,0.5,2,872,0.642,0.5,2,1022,0.752,0.5,2,1214,0.893,0.5,4,1311,0.965,1.0,4,1342,0.987,1.0,4,1347,0.991,1.0
594,725,1,1360,0,482,0.354,0.0,1,873,0.642,1.0,1,1023,0.752,1.0,1,1215,0.893,1.0,1,1312,0.965,1.0,1,1343,0.988,1.0,1,1348,0.991,1.0
595,726,3,1363,0,482,0.354,0.0,0,873,0.64,0.0,1,1024,0.751,0.333,1,1216,0.892,0.333,2,1314,0.964,0.667,2,1345,0.987,0.667,3,1351,0.991,1.0
596,727,2,1365,0,482,0.353,0.0,0,873,0.64,0.0,1,1025,0.751,0.5,1,1217,0.892,0.5,1,1315,0.963,0.5,2,1347,0.987,1.0,2,1353,0.991,1.0
597,729,1,1366,0,482,0.353,0.0,0,873,0.639,0.0,0,1025,0.75,0.0,1,1218,0.892,1.0,1,1316,0.963,1.0,1,1348,0.987,1.0,1,1354,0.991,1.0
598,730,2,1368,0,482,0.352,0.0,1,874,0.639,0.5,1,1026,0.75,0.5,2,1220,0.892,1.0,2,1318,0.963,1.0,2,1350,0.987,1.0,2,1356,0.991,1.0
599,731,2,1370,0,482,0.352,0.0,0,874,0.638,0.0,0,1026,0.749,0.0,0,1220,0.891,0.0,1,1319,0.963,0.5,1,1351,0.986,0.5,2,1358,0.991,1.0
600,732,1,1371,0,482,0.352,0.0,0,874,0.637,0.0,0,1026,0.748,0.0,0,1220,0.89,0.0,0,1319,0.962,0.0,0,1351,0.985,0.0,1,1359,0.991,1.0
601,734,1,1372,0,482,0.351,0.0,0,874,0.637,0.0,0,1026,0.748,0.0,0,1220,0.889,0.0,1,1320,0.962,1.0,1,1352,0.985,1.0,1,1360,0.991,1.0
602,736,2,1374,0,482,0.351,0.0,2,876,0.638,1.0,2,1028,0.748,1.0,2,1222,0.889,1.0,2,1322,0.962,1.0,2,1354,0.985,1.0,2,1362,0.991,1.0
603,737,1,1375,0,482,0.351,0.0,1,877,0.638,1.0,1,1029,0.748,1.0,1,1223,0.889,1.0,1,1323,0.962,1.0,1,1355,0.985,1.0,1,1363,0.991,1.0
604,738,1,1376,0,482,0.35,0.0,0,877,0.637,0.0,0,1029,0.748,0.0,1,1224,0.89,1.0,1,1324,0.962,1.0,1,1356,0.985,1.0,1,1364,0.991,1.0
605,739,3,1379,1,483,0.35,0.333,1,878,0.637,0.333,3,1032,0.748,1.0,3,1227,0.89,1.0,3,1327,0.962,1.0,3,1359,0.985,1.0,3,1367,0.991,1.0
606,740,3,1382,0,483,0.349,0.0,1,879,0.636,0.333,1,1033,0.747,0.333,2,1229,0.889,0.667,3,1330,0.962,1.0,3,1362,0.986,1.0,3,1370,0.991,1.0
607,742,1,1383,0,483,0.349,0.0,0,879,0.636,0.0,0,1033,0.747,0.0,0,1229,0.889,0.0,0,1330,0.962,0.0,1,1363,0.986,1.0,1,1371,0.991,1.0
608,745,3,1386,1,484,0.349,0.333,1,880,0.635,0.333,1,1034,0.746,0.333,2,1231,0.888,0.667,3,1333,0.962,1.0,3,1366,0.986,1.0,3,1374,0.991,1.0
609,746,3,1389,0,484,0.348,0.0,0,880,0.634,0.0,0,1034,0.744,0.0,0,1231,0.886,0.0,2,1335,0.961,0.667,3,1369,0.986,1.0,3,1377,0.991,1.0
610,747,1,1390,0,484,0.348,0.0,0,880,0.633,0.0,0,1034,0.744,0.0,1,1232,0.886,1.0,1,1336,0.961,1.0,1,1370,0.986,1.0,1,1378,0.991,1.0
611,748,1,1391,0,484,0.348,0.0,0,880,0.633,0.0,0,1034,0.743,0.0,0,1232,0.886,0.0,1,1337,0.961,1.0,1,1371,0.986,1.0,1,1379,0.991,1.0
612,749,1,1392,0,484,0.348,0.0,1,881,0.633,1.0,1,1035,0.744,1.0,1,1233,0.886,1.0,1,1338,0.961,1.0,1,1372,0.986,1.0,1,1380,0.991,1.0
613,750,2,1394,0,484,0.347,0.0,1,882,0.633,0.5,1,1036,0.743,0.5,1,1234,0.885,0.5,2,1340,0.961,1.0,2,1374,0.986,1.0,2,1382,0.991,1.0
614,751,1,1395,0,484,0.347,0.0,0,882,0.632,0.0,0,1036,0.743,0.0,0,1234,0.885,0.0,1,1341,0.961,1.0,1,1375,0.986,1.0,1,1383,0.991,1.0
615,752,1,1396,0,484,0.347,0.0,1,883,0.633,1.0,1,1037,0.743,1.0,1,1235,0.885,1.0,1,1342,0.961,1.0,1,1376,0.986,1.0,1,1384,0.991,1.0
616,755,1,1397,0,484,0.346,0.0,0,883,0.632,0.0,1,1038,0.743,1.0,1,1236,0.885,1.0,1,1343,0.961,1.0,1,1377,0.986,1.0,1,1385,0.991,1.0
617,757,1,1398,0,484,0.346,0.0,0,883,0.632,0.0,0,1038,0.742,0.0,0,1236,0.884,0.0,0,1343,0.961,0.0,0,1377,0.985,0.0,0,1385,0.991,0.0
618,760,1,1399,0,484,0.346,0.0,0,883,0.631,0.0,0,1038,0.742,0.0,0,1236,0.883,0.0,1,1344,0.961,1.0,1,1378,0.985,1.0,1,1386,0.991,1.0
619,762,1,1400,0,484,0.346,0.0,0,883,0.631,0.0,0,1038,0.741,0.0,0,1236,0.883,0.0,0,1344,0.96,0.0,1,1379,0.985,1.0,1,1387,0.991,1.0
620,763,1,1401,0,484,0.345,0.0,0,883,0.63,0.0,0,1038,0.741,0.0,0,1236,0.882,0.0,1,1345,0.96,1.0,1,1380,0.985,1.0,1,1388,0.991,1.0
621,765,2,1403,0,484,0.345,0.0,0,883,0.629,0.0,0,1038,0.74,0.0,0,1236,0.881,0.0,0,1345,0.959,0.0,1,1381,0.984,0.5,1,1389,0.99,0.5
622,766,1,1404,0,484,0.345,0.0,0,883,0.629,0.0,0,1038,0.739,0.0,1,1237,0.881,1.0,1,1346,0.959,1.0,1,1382,0.984,1.0,1,1390,0.99,1.0
623,768,2,1406,1,485,0.345,0.5,1,884,0.629,0.5,1,1039,0.739,0.5,1,1238,0.881,0.5,1,1347,0.958,0.5,1,1383,0.984,0.5,1,1391,0.989,0.5
624,770,2,1408,1,486,0.345,0.5,1,885,0.629,0.5,1,1040,0.739,0.5,2,1240,0.881,1.0,2,1349,0.958,1.0,2,1385,0.984,1.0,2,1393,0.989,1.0
625,771,2,1410,0,486,0.345,0.0,1,886,0.628,0.5,2,1042,0.739,1.0,2,1242,0.881,1.0,2,1351,0.958,1.0,2,1387,0.984,1.0,2,1395,0.989,1.0
626,772,1,1411,1,487,0.345,1.0,1,887,0.629,1.0,1,1043,0.739,1.0,1,1243,0.881,1.0,1,1352,0.958,1.0,1,1388,0.984,1.0,1,1396,0.989,1.0
627,773,2,1413,1,488,0.345,0.5,1,888,0.628,0.5,1,1044,0.739,0.5,1,1244,0.88,0.5,1,1353,0.958,0.5,1,1389,0.983,0.5,2,1398,0.989,1.0
628,775,2,1415,0,488,0.345,0.0,0,888,0.628,0.0,1,1045,0.739,0.5,2,1246,0.881,1.0,2,1355,0.958,1.0,2,1391,0.983,1.0,2,1400,0.989,1.0
629,776,1,1416,0,488,0.345,0.0,0,888,0.627,0.0,0,1045,0.738,0.0,0,1246,0.88,0.0,0,1355,0.957,0.0,1,1392,0.983,1.0,1,1401,0.989,1.0
630,778,1,1417,0,488,0.344,0.0,0,888,0.627,0.0,0,1045,0.737,0.0,1,1247,0.88,1.0,1,1356,0.957,1.0,1,1393,0.983,1.0,1,1402,0.989,1.0
631,781,1,1418,0,488,0.344,0.0,0,888,0.626,0.0,0,1045,0.737,0.0,0,1247,0.879,0.0,1,1357,0.957,1.0,1,1394,0.983,1.0,1,1403,0.989,1.0
632,782,2,1420,0,488,0.344,0.0,0,888,0.625,0.0,1,1046,0.737,0.5,1,1248,0.879,0.5,1,1358,0.956,0.5,2,1396,0.983,1.0,2,1405,0.989,1.0
633,784,2,1422,0,488,0.343,0.0,0,888,0.624,0.0,0,1046,0.736,0.0,2,1250,0.879,1.0,2,1360,0.956,1.0,2,1398,0.983,1.0,2,1407,0.989,1.0
634,786,1,1423,0,488,0.343,0.0,1,889,0.625,1.0,1,1047,0.736,1.0,1,1251,0.879,1.0,1,1361,0.956,1.0,1,1399,0.983,1.0,1,1408,0.989,1.0
635,787,1,1424,0,488,0.343,0.0,1,890,0.625,1.0,1,1048,0.736,1.0,1,1252,0.879,1.0,1,1362,0.956,1.0,1,1400,0.983,1.0,1,1409,0.989,1.0
636,788,1,1425,0,488,0.342,0.0,0,890,0.625,0.0,0,1048,0.735,0.0,0,1252,0.879,0.0,1,1363,0.956,1.0,1,1401,0.983,1.0,1,1410,0.989,1.0
637,789,1,1426,0,488,0.342,0.0,1,891,0.625,1.0,1,1049,0.736,1.0,1,1253,0.879,1.0,1,1364,0.957,1.0,1,1402,0.983,1.0,1,1411,0.989,1.0
638,790,4,1430,1,489,0.342,0.25,2,893,0.624,0.5,2,1051,0.735,0.5,3,1256,0.878,0.75,3,1367,0.956,0.75,4,1406,0.983,1.0,4,1415,0.99,1.0
639,792,1,1431,0,489,0.342,0.0,0,893,0.624,0.0,0,1051,0.734,0.0,0,1256,0.878,0.0,0,1367,0.955,0.0,0,1406,0.983,0.0,0,1415,0.989,0.0
640,793,1,1432,0,489,0.341,0.0,0,893,0.624,0.0,0,1051,0.734,0.0,1,1257,0.878,1.0,1,1368,0.955,1.0,1,1407,0.983,1.0,1,1416,0.989,1.0
641,795,1,1433,0,489,0.341,0.0,0,893,0.623,0.0,0,1051,0.733,0.0,0,1257,0.877,0.0,0,1368,0.955,0.0,1,1408,0.983,1.0,1,1417,0.989,1.0
642,797,2,1435,0,489,0.341,0.0,2,895,0.624,1.0,2,1053,0.734,1.0,2,1259,0.877,1.0,2,1370,0.955,1.0,2,1410,0.983,1.0,2,1419,0.989,1.0
643,800,1,1436,0,489,0.341,0.0,0,895,0.623,0.0,0,1053,0.733,0.0,0,1259,0.877,0.0,0,1370,0.954,0.0,0,1410,0.982,0.0,1,1420,0.989,1.0
644,802,1,1437,0,489,0.34,0.0,0,895,0.623,0.0,0,1053,0.733,0.0,0,1259,0.876,0.0,0,1370,0.953,0.0,1,1411,0.982,1.0,1,1421,0.989,1.0
645,804,2,1439,1,490,0.341,0.5,1,896,0.623,0.5,1,1054,0.732,0.5,2,1261,0.876,1.0,2,1372,0.953,1.0,2,1413,0.982,1.0,2,1423,0.989,1.0
646,805,1,1440,0,490,0.34,0.0,0,896,0.622,0.0,0,1054,0.732,0.0,0,1261,0.876,0.0,1,1373,0.953,1.0,1,1414,0.982,1.0,1,1424,0.989,1.0
647,807,2,1442,0,490,0.34,0.0,0,896,0.621,0.0,0,1054,0.731,0.0,1,1262,0.875,0.5,2,1375,0.954,1.0,2,1416,0.982,1.0,2,1426,0.989,1.0
648,808,1,1443,1,491,0.34,1.0,1,897,0.622,1.0,1,1055,0.731,1.0,1,1263,0.875,1.0,1,1376,0.954,1.0,1,1417,0.982,1.0,1,1427,0.989,1.0
649,809,1,1444,1,492,0.341,1.0,1,898,0.622,1.0,1,1056,0.731,1.0,1,1264,0.875,1.0,1,1377,0.954,1.0,1,1418,0.982,1.0,1,1428,0.989,1.0
650,811,1,1445,0,492,0.34,0.0,0,898,0.621,0.0,1,1057,0.731,1.0,1,1265,0.875,1.0,1,1378,0.954,1.0,1,1419,0.982,1.0,1,1429,0.989,1.0
651,812,1,1446,0,492,0.34,0.0,1,899,0.622,1.0,1,1058,0.732,1.0,1,1266,0.876,1.0,1,1379,0.954,1.0,1,1420,0.982,1.0,1,1430,0.989,1.0
652,813,3,1449,1,493,0.34,0.333,2,901,0.622,0.667,2,1060,0.732,0.667,3,1269,0.876,1.0,3,1382,0.954,1.0,3,1423,0.982,1.0,3,1433,0.989,1.0
653,814,3,1452,1,494,0.34,0.333,1,902,0.621,0.333,1,1061,0.731,0.333,2,1271,0.875,0.667,2,1384,0.953,0.667,3,1426,0.982,1.0,3,1436,0.989,1.0
654,815,2,1454,0,494,0.34,0.0,1,903,0.621,0.5,1,1062,0.73,0.5,2,1273,0.876,1.0,2,1386,0.953,1.0,2,1428,0.982,1.0,2,1438,0.989,1.0
655,817,3,1457,0,494,0.339,0.0,0,903,0.62,0.0,0,1062,0.729,0.0,1,1274,0.874,0.333,2,1388,0.953,0.667,2,1430,0.981,0.667,3,1441,0.989,1.0
656,821,1,1458,0,494,0.339,0.0,0,903,0.619,0.0,0,1062,0.728,0.0,1,1275,0.874,1.0,1,1389,0.953,1.0,1,1431,0.981,1.0,1,1442,0.989,1.0
657,822,1,1459,0,494,0.339,0.0,0,903,0.619,0.0,0,1062,0.728,0.0,0,1275,0.874,0.0,1,1390,0.953,1.0,1,1432,0.981,1.0,1,1443,0.989,1.0
658,823,1,1460,0,494,0.338,0.0,0,903,0.618,0.0,0,1062,0.727,0.0,0,1275,0.873,0.0,0,1390,0.952,0.0,1,1433,0.982,1.0,1,1444,0.989,1.0
659,826,1,1461,0,494,0.338,0.0,0,903,0.618,0.0,0,1062,0.727,0.0,0,1275,0.873,0.0,0,1390,0.951,0.0,0,1433,0.981,0.0,1,1445,0.989,1.0
660,827,2,1463,0,494,0.338,0.0,0,903,0.617,0.0,0,1062,0.726,0.0,1,1276,0.872,0.5,2,1392,0.951,1.0,2,1435,0.981,1.0,2,1447,0.989,1.0
661,828,1,1464,0,494,0.337,0.0,0,903,0.617,0.0,1,1063,0.726,1.0,1,1277,0.872,1.0,1,1393,0.952,1.0,1,1436,0.981,1.0,1,1448,0.989,1.0
662,829,1,1465,0,494,0.337,0.0,0,903,0.616,0.0,0,1063,0.726,0.0,0,1277,0.872,0.0,0,1393,0.951,0.0,0,1436,0.98,0.0,0,1448,0.988,0.0
663,830,1,1466,0,494,0.337,0.0,1,904,0.617,1.0,1,1064,0.726,1.0,1,1278,0.872,1.0,1,1394,0.951,1.0,1,1437,0.98,1.0,1,1449,0.988,1.0
664,831,1,1467,1,495,0.337,1.0,1,905,0.617,1.0,1,1065,0.726,1.0,1,1279,0.872,1.0,1,1395,0.951,1.0,1,1438,0.98,1.0,1,1450,0.988,1.0
665,832,2,1469,0,495,0.337,0.0,1,906,0.617,0.5,1,1066,0.726,0.5,2,1281,0.872,1.0,2,1397,0.951,1.0,2,1440,0.98,1.0,2,1452,0.988,1.0
666,836,1,1470,0,495,0.337,0.0,0,906,0.616,0.0,0,1066,0.725,0.0,1,1282,0.872,1.0,1,1398,0.951,1.0,1,1441,0.98,1.0,1,1453,0.988,1.0
667,837,1,1471,0,495,0.337,0.0,0,906,0.616,0.0,0,1066,0.725,0.0,0,1282,0.872,0.0,1,1399,0.951,1.0,1,1442,0.98,1.0,1,1454,0.988,1.0
668,838,1,1472,0,495,0.336,0.0,0,906,0.615,0.0,0,1066,0.724,0.0,0,1282,0.871,0.0,1,1400,0.951,1.0,1,1443,0.98,1.0,1,1455,0.988,1.0
669,841,1,1473,0,495,0.336,0.0,0,906,0.615,0.0,1,1067,0.724,1.0,1,1283,0.871,1.0,1,1401,0.951,1.0,1,1444,0.98,1.0,1,1456,0.988,1.0
670,843,1,1474,0,495,0.336,0.0,0,906,0.615,0.0,0,1067,0.724,0.0,1,1284,0.871,1.0,1,1402,0.951,1.0,1,1445,0.98,1.0,1,1457,0.988,1.0
671,847,2,1476,0,495,0.335,0.0,0,906,0.614,0.0,0,1067,0.723,0.0,1,1285,0.871,0.5,2,1404,0.951,1.0,2,1447,0.98,1.0,2,1459,0.988,1.0
672,848,1,1477,0,495,0.335,0.0,0,906,0.613,0.0,0,1067,0.722,0.0,0,1285,0.87,0.0,1,1405,0.951,1.0,1,1448,0.98,1.0,1,1460,0.988,1.0
673,849,1,1478,0,495,0.335,0.0,1,907,0.614,1.0,1,1068,0.723,1.0,1,1286,0.87,1.0,1,1406,0.951,1.0,1,1449,0.98,1.0,1,1461,0.988,1.0
674,854,1,1479,0,495,0.335,0.0,0,907,0.613,0.0,0,1068,0.722,0.0,0,1286,0.87,0.0,0,1406,0.951,0.0,0,1449,0.98,0.0,1,1462,0.989,1.0
675,855,1,1480,0,495,0.334,0.0,0,907,0.613,0.0,0,1068,0.722,0.0,0,1286,0.869,0.0,0,1406,0.95,0.0,1,1450,0.98,1.0,1,1463,0.989,1.0
676,856,1,1481,0,495,0.334,0.0,1,908,0.613,1.0,1,1069,0.722,1.0,1,1287,0.869,1.0,1,1407,0.95,1.0,1,1451,0.98,1.0,1,1464,0.989,1.0
677,857,2,1483,0,495,0.334,0.0,1,909,0.613,0.5,1,1070,0.722,0.5,1,1288,0.869,0.5,1,1408,0.949,0.5,1,1452,0.979,0.5,1,1465,0.988,0.5
678,862,1,1484,0,495,0.334,0.0,0,909,0.613,0.0,0,1070,0.721,0.0,1,1289,0.869,1.0,1,1409,0.949,1.0,1,1453,0.979,1.0,1,1466,0.988,1.0
679,863,2,1486,0,495,0.333,0.0,0,909,0.612,0.0,0,1070,0.72,0.0,1,1290,0.868,0.5,2,1411,0.95,1.0,2,1455,0.979,1.0,2,1468,0.988,1.0
680,865,1,1487,0,495,0.333,0.0,0,909,0.611,0.0,1,1071,0.72,1.0,1,1291,0.868,1.0,1,1412,0.95,1.0,1,1456,0.979,1.0,1,1469,0.988,1.0
681,866,1,1488,0,495,0.333,0.0,1,910,0.612,1.0,1,1072,0.72,1.0,1,1292,0.868,1.0,1,1413,0.95,1.0,1,1457,0.979,1.0,1,1470,0.988,1.0
682,867,1,1489,0,495,0.332,0.0,0,910,0.611,0.0,1,1073,0.721,1.0,1,1293,0.868,1.0,1,1414,0.95,1.0,1,1458,0.979,1.0,1,1471,0.988,1.0
683,868,1,1490,0,495,0.332,0.0,1,911,0.611,1.0,1,1074,0.721,1.0,1,1294,0.868,1.0,1,1415,0.95,1.0,1,1459,0.979,1.0,1,1472,0.988,1.0
684,869,1,1491,0,495,0.332,0.0,0,911,0.611,0.0,0,1074,0.72,0.0,0,1294,0.868,0.0,1,1416,0.95,1.0,1,1460,0.979,1.0,1,1473,0.988,1.0
685,870,1,1492,0,495,0.332,0.0,0,911,0.611,0.0,0,1074,0.72,0.0,0,1294,0.867,0.0,0,1416,0.949,0.0,0,1460,0.979,0.0,1,1474,0.988,1.0
686,871,1,1493,0,495,0.332,0.0,0,911,0.61,0.0,0,1074,0.719,0.0,0,1294,0.867,0.0,0,1416,0.948,0.0,1,1461,0.979,1.0,1,1475,0.988,1.0
687,877,1,1494,0,495,0.331,0.0,0,911,0.61,0.0,0,1074,0.719,0.0,0,1294,0.866,0.0,1,1417,0.948,1.0,1,1462,0.979,1.0,1,1476,0.988,1.0
688,878,2,1496,0,495,0.331,0.0,0,911,0.609,0.0,0,1074,0.718,0.0,1,1295,0.866,0.5,1,1418,0.948,0.5,2,1464,0.979,1.0,2,1478,0.988,1.0
689,880,1,1497,0,495,0.331,0.0,0,911,0.609,0.0,1,1075,0.718,1.0,1,1296,0.866,1.0,1,1419,0.948,1.0,1,1465,0.979,1.0,1,1479,0.988,1.0
690,882,1,1498,0,495,0.33,0.0,0,911,0.608,0.0,0,1075,0.718,0.0,1,1297,0.866,1.0,1,1420,0.948,1.0,1,1466,0.979,1.0,1,1480,0.988,1.0
691,884,1,1499,0,495,0.33,0.0,0,911,0.608,0.0,0,1075,0.717,0.0,0,1297,0.865,0.0,0,1420,0.947,0.0,0,1466,0.978,0.0,0,1480,0.987,0.0
692,886,1,1500,0,495,0.33,0.0,0,911,0.607,0.0,0,1075,0.717,0.0,1,1298,0.865,1.0,1,1421,0.947,1.0,1,1467,0.978,1.0,1,1481,0.987,1.0
693,887,1,1501,0,495,0.33,0.0,0,911,0.607,0.0,0,1075,0.716,0.0,0,1298,0.865,0.0,1,1422,0.947,1.0,1,1468,0.978,1.0,1,1482,0.987,1.0
694,888,2,1503,0,495,0.329,0.0,0,911,0.606,0.0,0,1075,0.715,0.0,2,1300,0.865,1.0,2,1424,0.947,1.0,2,1470,0.978,1.0,2,1484,0.987,1.0
695,890,2,1505,0,495,0.329,0.0,0,911,0.605,0.0,0,1075,0.714,0.0,1,1301,0.864,0.5,2,1426,0.948,1.0,2,1472,0.978,1.0,2,1486,0.987,1.0
696,891,1,1506,0,495,0.329,0.0,0,911,0.605,0.0,0,1075,0.714,0.0,1,1302,0.865,1.0,1,1427,0.948,1.0,1,1473,0.978,1.0,1,1487,0.987,1.0
697,893,3,1509,0,495,0.328,0.0,1,912,0.604,0.333,2,1077,0.714,0.667,2,1304,0.864,0.667,2,1429,0.947,0.667,2,1475,0.977,0.667,2,1489,0.987,0.667
698,894,1,1510,0,495,0.328,0.0,0,912,0.604,0.0,1,1078,0.714,1.0,1,1305,0.864,1.0,1,1430,0.947,1.0,1,1476,0.977,1.0,1,1490,0.987,1.0
699,896,1,1511,0,495,0.328,0.0,0,912,0.604,0.0,0,1078,0.713,0.0,0,1305,0.864,0.0,1,1431,0.947,1.0,1,1477,0.977,1.0,1,1491,0.987,1.0
700,898,1,1512,0,495,0.327,0.0,0,912,0.603,0.0,0,1078,0.713,0.0,0,1305,0.863,0.0,1,1432,0.947,1.0,1,1478,0.978,1.0,1,1492,0.987,1.0
701,900,2,1514,0,495,0.327,0.0,0,912,0.602,0.0,0,1078,0.712,0.0,1,1306,0.863,0.5,1,1433,0.946,0.5,1,1479,0.977,0.5,1,1493,0.986,0.5
702,901,1,1515,0,495,0.327,0.0,0,912,0.602,0.0,0,1078,0.712,0.0,1,1307,0.863,1.0,1,1434,0.947,1.0,1,1480,0.977,1.0,1,1494,0.986,1.0
703,903,1,1516,0,495,0.327,0.0,0,912,0.602,0.0,0,1078,0.711,0.0,0,1307,0.862,0.0,1,1435,0.947,1.0,1,1481,0.977,1.0,1,1495,0.986,1.0
704,905,2,1518,0,495,0.326,0.0,1,913,0.601,0.5,1,1079,0.711,0.5,1,1308,0.862,0.5,1,1436,0.946,0.5,1,1482,0.976,0.5,1,1496,0.986,0.5
705,909,1,1519,0,495,0.326,0.0,0,913,0.601,0.0,0,1079,0.71,0.0,1,1309,0.862,1.0,1,1437,0.946,1.0,1,1483,0.976,1.0,1,1497,0.986,1.0
706,911,2,1521,0,495,0.325,0.0,0,913,0.6,0.0,1,1080,0.71,0.5,1,1310,0.861,0.5,2,1439,0.946,1.0,2,1485,0.976,1.0,2,1499,0.986,1.0
707,912,1,1522,0,495,0.325,0.0,0,913,0.6,0.0,0,1080,0.71,0.0,1,1311,0.861,1.0,1,1440,0.946,1.0,1,1486,0.976,1.0,1,1500,0.986,1.0
708,914,2,1524,0,495,0.325,0.0,0,913,0.599,0.0,0,1080,0.709,0.0,1,1312,0.861,0.5,1,1441,0.946,0.5,1,1487,0.976,0.5,1,1501,0.985,0.5
709,915,1,1525,1,496,0.325,1.0,1,914,0.599,1.0,1,1081,0.709,1.0,1,1313,0.861,1.0,1,1442,0.946,1.0,1,1488,0.976,1.0,1,1502,0.985,1.0
710,917,1,1526,0,496,0.325,0.0,0,914,0.599,0.0,0,1081,0.708,0.0,1,1314,0.861,1.0,1,1443,0.946,1.0,1,1489,0.976,1.0,1,1503,0.985,1.0
711,920,1,1527,0,496,0.325,0.0,0,914,0.599,0.0,0,1081,0.708,0.0,0,1314,0.861,0.0,0,1443,0.945,0.0,1,1490,0.976,1.0,1,1504,0.985,1.0
712,921,1,1528,0,496,0.325,0.0,0,914,0.598,0.0,0,1081,0.707,0.0,0,1314,0.86,0.0,1,1444,0.945,1.0,1,1491,0.976,1.0,1,1505,0.985,1.0
713,922,1,1529,0,496,0.324,0.0,0,914,0.598,0.0,0,1081,0.707,0.0,1,1315,0.86,1.0,1,1445,0.945,1.0,1,1492,0.976,1.0,1,1506,0.985,1.0
714,926,2,1531,0,496,0.324,0.0,0,914,0.597,0.0,0,1081,0.706,0.0,1,1316,0.86,0.5,1,1446,0.944,0.5,1,1493,0.975,0.5,1,1507,0.984,0.5
715,932,1,1532,0,496,0.324,0.0,0,914,0.597,0.0,0,1081,0.706,0.0,1,1317,0.86,1.0,1,1447,0.945,1.0,1,1494,0.975,1.0,1,1508,0.984,1.0
716,933,1,1533,0,496,0.324,0.0,0,914,0.596,0.0,0,1081,0.705,0.0,1,1318,0.86,1.0,1,1448,0.945,1.0,1,1495,0.975,1.0,1,1509,0.984,1.0
717,934,1,1534,1,497,0.324,1.0,1,915,0.596,1.0,1,1082,0.705,1.0,1,1319,0.86,1.0,1,1449,0.945,1.0,1,1496,0.975,1.0,1,1510,0.984,1.0
718,935,1,1535,0,497,0.324,0.0,0,915,0.596,0.0,0,1082,0.705,0.0,0,1319,0.859,0.0,1,1450,0.945,1.0,1,1497,0.975,1.0,1,1511,0.984,1.0
719,936,1,1536,0,497,0.324,0.0,0,915,0.596,0.0,1,1083,0.705,1.0,1,1320,0.859,1.0,1,1451,0.945,1.0,1,1498,0.975,1.0,1,1512,0.984,1.0
720,938,1,1537,0,497,0.323,0.0,0,915,0.595,0.0,0,1083,0.705,0.0,1,1321,0.859,1.0,1,1452,0.945,1.0,1,1499,0.975,1.0,1,1513,0.984,1.0
721,939,1,1538,0,497,0.323,0.0,1,916,0.596,1.0,1,1084,0.705,1.0,1,1322,0.86,1.0,1,1453,0.945,1.0,1,1500,0.975,1.0,1,1514,0.984,1.0
722,942,1,1539,0,497,0.323,0.0,1,917,0.596,1.0,1,1085,0.705,1.0,1,1323,0.86,1.0,1,1454,0.945,1.0,1,1501,0.975,1.0,1,1515,0.984,1.0
723,943,1,1540,0,497,0.323,0.0,1,918,0.596,1.0,1,1086,0.705,1.0,1,1324,0.86,1.0,1,1455,0.945,1.0,1,1502,0.975,1.0,1,1516,0.984,1.0
724,944,3,1543,0,497,0.322,0.0,1,919,0.596,0.333,1,1087,0.704,0.333,2,1326,0.859,0.667,2,1457,0.944,0.667,3,1505,0.975,1.0,3,1519,0.984,1.0
725,946,1,1544,0,497,0.322,0.0,1,920,0.596,1.0,1,1088,0.705,1.0,1,1327,0.859,1.0,1,1458,0.944,1.0,1,1506,0.975,1.0,1,1520,0.984,1.0
726,947,1,1545,0,497,0.322,0.0,0,920,0.595,0.0,0,1088,0.704,0.0,1,1328,0.86,1.0,1,1459,0.944,1.0,1,1507,0.975,1.0,1,1521,0.984,1.0
727,948,1,1546,0,497,0.321,0.0,0,920,0.595,0.0,0,1088,0.704,0.0,0,1328,0.859,0.0,0,1459,0.944,0.0,1,1508,0.975,1.0,1,1522,0.984,1.0
728,950,1,1547,0,497,0.321,0.0,0,920,0.595,0.0,1,1089,0.704,1.0,1,1329,0.859,1.0,1,1460,0.944,1.0,1,1509,0.975,1.0,1,1523,0.984,1.0
729,952,1,1548,0,497,0.321,0.0,0,920,0.594,0.0,0,1089,0.703,0.0,0,1329,0.859,0.0,1,1461,0.944,1.0,1,1510,0.975,1.0,1,1524,0.984,1.0
730,956,2,1550,0,497,0.321,0.0,0,920,0.594,0.0,0,1089,0.703,0.0,1,1330,0.858,0.5,1,1462,0.943,0.5,1,1511,0.975,0.5,2,1526,0.985,1.0
731,957,3,1553,0,497,0.32,0.0,0,920,0.592,0.0,0,1089,0.701,0.0,2,1332,0.858,0.667,3,1465,0.943,1.0,3,1514,0.975,1.0,3,1529,0.985,1.0
732,961,2,1555,0,497,0.32,0.0,0,920,0.592,0.0,0,1089,0.7,0.0,1,1333,0.857,0.5,2,1467,0.943,1.0,2,1516,0.975,1.0,2,1531,0.985,1.0
733,962,1,1556,0,497,0.319,0.0,0,920,0.591,0.0,0,1089,0.7,0.0,0,1333,0.857,0.0,0,1467,0.943,0.0,0,1516,0.974,0.0,0,1531,0.984,0.0
734,963,1,1557,0,497,0.319,0.0,0,920,0.591,0.0,0,1089,0.699,0.0,1,1334,0.857,1.0,1,1468,0.943,1.0,1,1517,0.974,1.0,1,1532,0.984,1.0
735,964,1,1558,0,497,0.319,0.0,0,920,0.591,0.0,0,1089,0.699,0.0,0,1334,0.856,0.0,1,1469,0.943,1.0,1,1518,0.974,1.0,1,1533,0.984,1.0
736,965,1,1559,0,497,0.319,0.0,0,920,0.59,0.0,1,1090,0.699,1.0,1,1335,0.856,1.0,1,1470,0.943,1.0,1,1519,0.974,1.0,1,1534,0.984,1.0
737,966,1,1560,0,497,0.319,0.0,0,920,0.59,0.0,0,1090,0.699,0.0,0,1335,0.856,0.0,1,1471,0.943,1.0,1,1520,0.974,1.0,1,1535,0.984,1.0
738,970,1,1561,0,497,0.318,0.0,0,920,0.589,0.0,0,1090,0.698,0.0,1,1336,0.856,1.0,1,1472,0.943,1.0,1,1521,0.974,1.0,1,1536,0.984,1.0
739,971,1,1562,0,497,0.318,0.0,0,920,0.589,0.0,0,1090,0.698,0.0,0,1336,0.855,0.0,1,1473,0.943,1.0,1,1522,0.974,1.0,1,1537,0.984,1.0
740,979,1,1563,0,497,0.318,0.0,0,920,0.589,0.0,0,1090,0.697,0.0,0,1336,0.855,0.0,0,1473,0.942,0.0,0,1522,0.974,0.0,1,1538,0.984,1.0
741,981,1,1564,0,497,0.318,0.0,0,920,0.588,0.0,0,1090,0.697,0.0,0,1336,0.854,0.0,1,1474,0.942,1.0,1,1523,0.974,1.0,1,1539,0.984,1.0
742,985,2,1566,0,497,0.317,0.0,0,920,0.587,0.0,1,1091,0.697,0.5,2,1338,0.854,1.0,2,1476,0.943,1.0,2,1525,0.974,1.0,2,1541,0.984,1.0
743,990,1,1567,0,497,0.317,0.0,0,920,0.587,0.0,1,1092,0.697,1.0,1,1339,0.854,1.0,1,1477,0.943,1.0,1,1526,0.974,1.0,1,1542,0.984,1.0
744,991,1,1568,0,497,0.317,0.0,1,921,0.587,1.0,1,1093,0.697,1.0,1,1340,0.855,1.0,1,1478,0.943,1.0,1,1527,0.974,1.0,1,1543,0.984,1.0
745,992,1,1569,0,497,0.317,0.0,1,922,0.588,1.0,1,1094,0.697,1.0,1,1341,0.855,1.0,1,1479,0.943,1.0,1,1528,0.974,1.0,1,1544,0.984,1.0
746,994,2,1571,0,497,0.316,0.0,1,923,0.588,0.5,1,1095,0.697,0.5,1,1342,0.854,0.5,2,1481,0.943,1.0,2,1530,0.974,1.0,2,1546,0.984,1.0
747,996,1,1572,0,497,0.316,0.0,0,923,0.587,0.0,0,1095,0.697,0.0,0,1342,0.854,0.0,1,1482,0.943,1.0,1,1531,0.974,1.0,1,1547,0.984,1.0
748,998,1,1573,0,497,0.316,0.0,0,923,0.587,0.0,1,1096,0.697,1.0,1,1343,0.854,1.0,1,1483,0.943,1.0,1,1532,0.974,1.0,1,1548,0.984,1.0
749,999,1,1574,0,497,0.316,0.0,0,923,0.586,0.0,0,1096,0.696,0.0,0,1343,0.853,0.0,0,1483,0.942,0.0,1,1533,0.974,1.0,1,1549,0.984,1.0
