,idx,pop_num,pop_cum_num,ID_num_0.68,ID_cum_num_0.68,ID_cum_rate_0.68,ID_rate_0.68,ID_num_0.9,ID_cum_num_0.9,ID_cum_rate_0.9,ID_rate_0.9,ID_num_0.95,ID_cum_num_0.95,ID_cum_rate_0.95,ID_rate_0.95,ID_num_0.99,ID_cum_num_0.99,ID_cum_rate_0.99,ID_rate_0.99,ID_num_0.999,ID_cum_num_0.999,ID_cum_rate_0.999,ID_rate_0.999,ID_num_0.9999,ID_cum_num_0.9999,ID_cum_rate_0.9999,ID_rate_0.9999,ID_num_0.99999,ID_cum_num_0.99999,ID_cum_rate_0.99999,ID_rate_0.99999
0,1,2,2,1,1,0.5,0.5,2,2,1.0,1.0,2,2,1.0,1.0,2,2,1.0,1.0,2,2,1.0,1.0,2,2,1.0,1.0,2,2,1.0,1.0
1,2,1,3,1,2,0.667,1.0,1,3,1.0,1.0,1,3,1.0,1.0,1,3,1.0,1.0,1,3,1.0,1.0,1,3,1.0,1.0,1,3,1.0,1.0
2,3,2,5,2,4,0.8,1.0,2,5,1.0,1.0,2,5,1.0,1.0,2,5,1.0,1.0,2,5,1.0,1.0,2,5,1.0,1.0,2,5,1.0,1.0
3,4,1,6,1,5,0.833,1.0,1,6,1.0,1.0,1,6,1.0,1.0,1,6,1.0,1.0,1,6,1.0,1.0,1,6,1.0,1.0,1,6,1.0,1.0
4,6,3,9,1,6,0.667,0.333,3,9,1.0,1.0,3,9,1.0,1.0,3,9,1.0,1.0,3,9,1.0,1.0,3,9,1.0,1.0,3,9,1.0,1.0
5,7,5,14,3,9,0.643,0.6,4,13,0.929,0.8,4,13,0.929,0.8,5,14,1.0,1.0,5,14,1.0,1.0,5,14,1.0,1.0,5,14,1.0,1.0
6,8,3,17,1,10,0.588,0.333,3,16,0.941,1.0,3,16,0.941,1.0,3,17,1.0,1.0,3,17,1.0,1.0,3,17,1.0,1.0,3,17,1.0,1.0
7,9,3,20,2,12,0.6,0.667,3,19,0.95,1.0,3,19,0.95,1.0,3,20,1.0,1.0,3,20,1.0,1.0,3,20,1.0,1.0,3,20,1.0,1.0
8,11,2,22,2,14,0.636,1.0,2,21,0.955,1.0,2,21,0.955,1.0,2,22,1.0,1.0,2,22,1.0,1.0,2,22,1.0,1.0,2,22,1.0,1.0
9,12,3,25,3,17,0.68,1.0,3,24,0.96,1.0,3,24,0.96,1.0,3,25,1.0,1.0,3,25,1.0,1.0,3,25,1.0,1.0,3,25,1.0,1.0
10,13,1,26,1,18,0.692,1.0,1,25,0.962,1.0,1,25,0.962,1.0,1,26,1.0,1.0,1,26,1.0,1.0,1,26,1.0,1.0,1,26,1.0,1.0
11,14,1,27,1,19,0.704,1.0,1,26,0.963,1.0,1,26,0.963,1.0,1,27,1.0,1.0,1,27,1.0,1.0,1,27,1.0,1.0,1,27,1.0,1.0
12,15,4,31,3,22,0.71,0.75,3,29,0.935,0.75,3,29,0.935,0.75,3,30,0.968,0.75,4,31,1.0,1.0,4,31,1.0,1.0,4,31,1.0,1.0
13,16,2,33,1,23,0.697,0.5,1,30,0.909,0.5,1,30,0.909,0.5,2,32,0.97,1.0,2,33,1.0,1.0,2,33,1.0,1.0,2,33,1.0,1.0
14,17,2,35,1,24,0.686,0.5,2,32,0.914,1.0,2,32,0.914,1.0,2,34,0.971,1.0,2,35,1.0,1.0,2,35,1.0,1.0,2,35,1.0,1.0
15,18,3,38,1,25,0.658,0.333,2,34,0.895,0.667,3,35,0.921,1.0,3,37,0.974,1.0,3,38,1.0,1.0,3,38,1.0,1.0,3,38,1.0,1.0
16,19,1,39,1,26,0.667,1.0,1,35,0.897,1.0,1,36,0.923,1.0,1,38,0.974,1.0,1,39,1.0,1.0,1,39,1.0,1.0,1,39,1.0,1.0
17,21,3,42,3,29,0.69,1.0,3,38,0.905,1.0,3,39,0.929,1.0,3,41,0.976,1.0,3,42,1.0,1.0,3,42,1.0,1.0,3,42,1.0,1.0
18,22,2,44,1,30,0.682,0.5,2,40,0.909,1.0,2,41,0.932,1.0,2,43,0.977,1.0,2,44,1.0,1.0,2,44,1.0,1.0,2,44,1.0,1.0
19,24,1,45,0,30,0.667,0.0,0,40,0.889,0.0,0,41,0.911,0.0,1,44,0.978,1.0,1,45,1.0,1.0,1,45,1.0,1.0,1,45,1.0,1.0
20,25,2,47,2,32,0.681,1.0,2,42,0.894,1.0,2,43,0.915,1.0,2,46,0.979,1.0,2,47,1.0,1.0,2,47,1.0,1.0,2,47,1.0,1.0
21,26,3,50,3,35,0.7,1.0,3,45,0.9,1.0,3,46,0.92,1.0,3,49,0.98,1.0,3,50,1.0,1.0,3,50,1.0,1.0,3,50,1.0,1.0
22,27,4,54,1,36,0.667,0.25,4,49,0.907,1.0,4,50,0.926,1.0,4,53,0.981,1.0,4,54,1.0,1.0,4,54,1.0,1.0,4,54,1.0,1.0
23,28,3,57,2,38,0.667,0.667,3,52,0.912,1.0,3,53,0.93,1.0,3,56,0.982,1.0,3,57,1.0,1.0,3,57,1.0,1.0,3,57,1.0,1.0
24,29,2,59,0,38,0.644,0.0,2,54,0.915,1.0,2,55,0.932,1.0,2,58,0.983,1.0,2,59,1.0,1.0,2,59,1.0,1.0,2,59,1.0,1.0
25,30,3,62,3,41,0.661,1.0,3,57,0.919,1.0,3,58,0.935,1.0,3,61,0.984,1.0,3,62,1.0,1.0,3,62,1.0,1.0,3,62,1.0,1.0
26,31,3,65,2,43,0.662,0.667,3,60,0.923,1.0,3,61,0.938,1.0,3,64,0.985,1.0,3,65,1.0,1.0,3,65,1.0,1.0,3,65,1.0,1.0
27,32,4,69,3,46,0.667,0.75,4,64,0.928,1.0,4,65,0.942,1.0,4,68,0.986,1.0,4,69,1.0,1.0,4,69,1.0,1.0,4,69,1.0,1.0
28,33,3,72,3,49,0.681,1.0,3,67,0.931,1.0,3,68,0.944,1.0,3,71,0.986,1.0,3,72,1.0,1.0,3,72,1.0,1.0,3,72,1.0,1.0
29,34,1,73,0,49,0.671,0.0,1,68,0.932,1.0,1,69,0.945,1.0,1,72,0.986,1.0,1,73,1.0,1.0,1,73,1.0,1.0,1,73,1.0,1.0
30,35,2,75,1,50,0.667,0.5,1,69,0.92,0.5,1,70,0.933,0.5,2,74,0.987,1.0,2,75,1.0,1.0,2,75,1.0,1.0,2,75,1.0,1.0
31,37,2,77,2,52,0.675,1.0,2,71,0.922,1.0,2,72,0.935,1.0,2,76,0.987,1.0,2,77,1.0,1.0,2,77,1.0,1.0,2,77,1.0,1.0
32,38,1,78,1,53,0.679,1.0,1,72,0.923,1.0,1,73,0.936,1.0,1,77,0.987,1.0,1,78,1.0,1.0,1,78,1.0,1.0,1,78,1.0,1.0
33,39,2,80,0,53,0.662,0.0,2,74,0.925,1.0,2,75,0.938,1.0,2,79,0.988,1.0,2,80,1.0,1.0,2,80,1.0,1.0,2,80,1.0,1.0
34,40,3,83,2,55,0.663,0.667,3,77,0.928,1.0,3,78,0.94,1.0,3,82,0.988,1.0,3,83,1.0,1.0,3,83,1.0,1.0,3,83,1.0,1.0
35,41,1,84,1,56,0.667,1.0,1,78,0.929,1.0,1,79,0.94,1.0,1,83,0.988,1.0,1,84,1.0,1.0,1,84,1.0,1.0,1,84,1.0,1.0
36,42,4,88,3,59,0.67,0.75,4,82,0.932,1.0,4,83,0.943,1.0,4,87,0.989,1.0,4,88,1.0,1.0,4,88,1.0,1.0,4,88,1.0,1.0
37,43,7,95,5,64,0.674,0.714,7,89,0.937,1.0,7,90,0.947,1.0,7,94,0.989,1.0,7,95,1.0,1.0,7,95,1.0,1.0,7,95,1.0,1.0
38,44,3,98,2,66,0.673,0.667,3,92,0.939,1.0,3,93,0.949,1.0,3,97,0.99,1.0,3,98,1.0,1.0,3,98,1.0,1.0,3,98,1.0,1.0
39,45,2,100,2,68,0.68,1.0,2,94,0.94,1.0,2,95,0.95,1.0,2,99,0.99,1.0,2,100,1.0,1.0,2,100,1.0,1.0,2,100,1.0,1.0
40,47,2,102,2,70,0.686,1.0,2,96,0.941,1.0,2,97,0.951,1.0,2,101,0.99,1.0,2,102,1.0,1.0,2,102,1.0,1.0,2,102,1.0,1.0
41,48,6,108,2,72,0.667,0.333,5,101,0.935,0.833,5,102,0.944,0.833,6,107,0.991,1.0,6,108,1.0,1.0,6,108,1.0,1.0,6,108,1.0,1.0
42,49,1,109,1,73,0.67,1.0,1,102,0.936,1.0,1,103,0.945,1.0,1,108,0.991,1.0,1,109,1.0,1.0,1,109,1.0,1.0,1,109,1.0,1.0
43,50,4,113,3,76,0.673,0.75,4,106,0.938,1.0,4,107,0.947,1.0,4,112,0.991,1.0,4,113,1.0,1.0,4,113,1.0,1.0,4,113,1.0,1.0
44,52,2,115,1,77,0.67,0.5,1,107,0.93,0.5,1,108,0.939,0.5,2,114,0.991,1.0,2,115,1.0,1.0,2,115,1.0,1.0,2,115,1.0,1.0
45,53,1,116,0,77,0.664,0.0,0,107,0.922,0.0,0,108,0.931,0.0,0,114,0.983,0.0,1,116,1.0,1.0,1,116,1.0,1.0,1,116,1.0,1.0
46,54,3,119,3,80,0.672,1.0,3,110,0.924,1.0,3,111,0.933,1.0,3,117,0.983,1.0,3,119,1.0,1.0,3,119,1.0,1.0,3,119,1.0,1.0
47,55,2,121,2,82,0.678,1.0,2,112,0.926,1.0,2,113,0.934,1.0,2,119,0.983,1.0,2,121,1.0,1.0,2,121,1.0,1.0,2,121,1.0,1.0
48,56,4,125,4,86,0.688,1.0,4,116,0.928,1.0,4,117,0.936,1.0,4,123,0.984,1.0,4,125,1.0,1.0,4,125,1.0,1.0,4,125,1.0,1.0
49,57,5,130,5,91,0.7,1.0,5,121,0.931,1.0,5,122,0.938,1.0,5,128,0.985,1.0,5,130,1.0,1.0,5,130,1.0,1.0,5,130,1.0,1.0
50,58,3,133,1,92,0.692,0.333,3,124,0.932,1.0,3,125,0.94,1.0,3,131,0.985,1.0,3,133,1.0,1.0,3,133,1.0,1.0,3,133,1.0,1.0
51,59,2,135,1,93,0.689,0.5,2,126,0.933,1.0,2,127,0.941,1.0,2,133,0.985,1.0,2,135,1.0,1.0,2,135,1.0,1.0,2,135,1.0,1.0
52,60,2,137,1,94,0.686,0.5,2,128,0.934,1.0,2,129,0.942,1.0,2,135,0.985,1.0,2,137,1.0,1.0,2,137,1.0,1.0,2,137,1.0,1.0
53,61,3,140,2,96,0.686,0.667,3,131,0.936,1.0,3,132,0.943,1.0,3,138,0.986,1.0,3,140,1.0,1.0,3,140,1.0,1.0,3,140,1.0,1.0
54,62,1,141,0,96,0.681,0.0,1,132,0.936,1.0,1,133,0.943,1.0,1,139,0.986,1.0,1,141,1.0,1.0,1,141,1.0,1.0,1,141,1.0,1.0
55,63,3,144,3,99,0.688,1.0,3,135,0.938,1.0,3,136,0.944,1.0,3,142,0.986,1.0,3,144,1.0,1.0,3,144,1.0,1.0,3,144,1.0,1.0
56,64,4,148,2,101,0.682,0.5,4,139,0.939,1.0,4,140,0.946,1.0,4,146,0.986,1.0,4,148,1.0,1.0,4,148,1.0,1.0,4,148,1.0,1.0
57,65,1,149,1,102,0.685,1.0,1,140,0.94,1.0,1,141,0.946,1.0,1,147,0.987,1.0,1,149,1.0,1.0,1,149,1.0,1.0,1,149,1.0,1.0
58,66,4,153,2,104,0.68,0.5,4,144,0.941,1.0,4,145,0.948,1.0,4,151,0.987,1.0,4,153,1.0,1.0,4,153,1.0,1.0,4,153,1.0,1.0
59,67,6,159,3,107,0.673,0.5,5,149,0.937,0.833,6,151,0.95,1.0,6,157,0.987,1.0,6,159,1.0,1.0,6,159,1.0,1.0,6,159,1.0,1.0
60,68,1,160,0,107,0.669,0.0,1,150,0.938,1.0,1,152,0.95,1.0,1,158,0.988,1.0,1,160,1.0,1.0,1,160,1.0,1.0,1,160,1.0,1.0
61,69,2,162,2,109,0.673,1.0,2,152,0.938,1.0,2,154,0.951,1.0,2,160,0.988,1.0,2,162,1.0,1.0,2,162,1.0,1.0,2,162,1.0,1.0
62,70,3,165,1,110,0.667,0.333,3,155,0.939,1.0,3,157,0.952,1.0,3,163,0.988,1.0,3,165,1.0,1.0,3,165,1.0,1.0,3,165,1.0,1.0
63,71,4,169,1,111,0.657,0.25,3,158,0.935,0.75,4,161,0.953,1.0,4,167,0.988,1.0,4,169,1.0,1.0,4,169,1.0,1.0,4,169,1.0,1.0
64,72,2,171,0,111,0.649,0.0,2,160,0.936,1.0,2,163,0.953,1.0,2,169,0.988,1.0,2,171,1.0,1.0,2,171,1.0,1.0,2,171,1.0,1.0
65,73,1,172,1,112,0.651,1.0,1,161,0.936,1.0,1,164,0.953,1.0,1,170,0.988,1.0,1,172,1.0,1.0,1,172,1.0,1.0,1,172,1.0,1.0
66,74,3,175,2,114,0.651,0.667,3,164,0.937,1.0,3,167,0.954,1.0,3,173,0.989,1.0,3,175,1.0,1.0,3,175,1.0,1.0,3,175,1.0,1.0
67,75,1,176,0,114,0.648,0.0,1,165,0.938,1.0,1,168,0.955,1.0,1,174,0.989,1.0,1,176,1.0,1.0,1,176,1.0,1.0,1,176,1.0,1.0
68,76,3,179,3,117,0.654,1.0,3,168,0.939,1.0,3,171,0.955,1.0,3,177,0.989,1.0,3,179,1.0,1.0,3,179,1.0,1.0,3,179,1.0,1.0
69,77,5,184,3,120,0.652,0.6,3,171,0.929,0.6,5,176,0.957,1.0,5,182,0.989,1.0,5,184,1.0,1.0,5,184,1.0,1.0,5,184,1.0,1.0
70,78,7,191,3,123,0.644,0.429,5,176,0.921,0.714,7,183,0.958,1.0,7,189,0.99,1.0,7,191,1.0,1.0,7,191,1.0,1.0,7,191,1.0,1.0
71,79,3,194,2,125,0.644,0.667,3,179,0.923,1.0,3,186,0.959,1.0,3,192,0.99,1.0,3,194,1.0,1.0,3,194,1.0,1.0,3,194,1.0,1.0
72,80,1,195,0,125,0.641,0.0,0,179,0.918,0.0,0,186,0.954,0.0,1,193,0.99,1.0,1,195,1.0,1.0,1,195,1.0,1.0,1,195,1.0,1.0
73,81,2,197,1,126,0.64,0.5,1,180,0.914,0.5,2,188,0.954,1.0,2,195,0.99,1.0,2,197,1.0,1.0,2,197,1.0,1.0,2,197,1.0,1.0
74,82,3,200,3,129,0.645,1.0,3,183,0.915,1.0,3,191,0.955,1.0,3,198,0.99,1.0,3,200,1.0,1.0,3,200,1.0,1.0,3,200,1.0,1.0
75,83,3,203,2,131,0.645,0.667,3,186,0.916,1.0,3,194,0.956,1.0,3,201,0.99,1.0,3,203,1.0,1.0,3,203,1.0,1.0,3,203,1.0,1.0
76,84,5,208,5,136,0.654,1.0,5,191,0.918,1.0,5,199,0.957,1.0,5,206,0.99,1.0,5,208,1.0,1.0,5,208,1.0,1.0,5,208,1.0,1.0
77,85,4,212,4,140,0.66,1.0,4,195,0.92,1.0,4,203,0.958,1.0,4,210,0.991,1.0,4,212,1.0,1.0,4,212,1.0,1.0,4,212,1.0,1.0
78,86,2,214,0,140,0.654,0.0,1,196,0.916,0.5,2,205,0.958,1.0,2,212,0.991,1.0,2,214,1.0,1.0,2,214,1.0,1.0,2,214,1.0,1.0
79,88,4,218,1,141,0.647,0.25,4,200,0.917,1.0,4,209,0.959,1.0,4,216,0.991,1.0,4,218,1.0,1.0,4,218,1.0,1.0,4,218,1.0,1.0
80,89,3,221,1,142,0.643,0.333,3,203,0.919,1.0,3,212,0.959,1.0,3,219,0.991,1.0,3,221,1.0,1.0,3,221,1.0,1.0,3,221,1.0,1.0
81,90,3,224,1,143,0.638,0.333,3,206,0.92,1.0,3,215,0.96,1.0,3,222,0.991,1.0,3,224,1.0,1.0,3,224,1.0,1.0,3,224,1.0,1.0
82,91,5,229,5,148,0.646,1.0,5,211,0.921,1.0,5,220,0.961,1.0,5,227,0.991,1.0,5,229,1.0,1.0,5,229,1.0,1.0,5,229,1.0,1.0
83,92,2,231,2,150,0.649,1.0,2,213,0.922,1.0,2,222,0.961,1.0,2,229,0.991,1.0,2,231,1.0,1.0,2,231,1.0,1.0,2,231,1.0,1.0
84,93,3,234,2,152,0.65,0.667,3,216,0.923,1.0,3,225,0.962,1.0,3,232,0.991,1.0,3,234,1.0,1.0,3,234,1.0,1.0,3,234,1.0,1.0
85,94,3,237,1,153,0.646,0.333,3,219,0.924,1.0,3,228,0.962,1.0,3,235,0.992,1.0,3,237,1.0,1.0,3,237,1.0,1.0,3,237,1.0,1.0
86,95,1,238,1,154,0.647,1.0,1,220,0.924,1.0,1,229,0.962,1.0,1,236,0.992,1.0,1,238,1.0,1.0,1,238,1.0,1.0,1,238,1.0,1.0
87,96,4,242,2,156,0.645,0.5,3,223,0.921,0.75,4,233,0.963,1.0,4,240,0.992,1.0,4,242,1.0,1.0,4,242,1.0,1.0,4,242,1.0,1.0
88,97,4,246,4,160,0.65,1.0,4,227,0.923,1.0,4,237,0.963,1.0,4,244,0.992,1.0,4,246,1.0,1.0,4,246,1.0,1.0,4,246,1.0,1.0
89,98,3,249,3,163,0.655,1.0,3,230,0.924,1.0,3,240,0.964,1.0,3,247,0.992,1.0,3,249,1.0,1.0,3,249,1.0,1.0,3,249,1.0,1.0
90,99,2,251,2,165,0.657,1.0,2,232,0.924,1.0,2,242,0.964,1.0,2,249,0.992,1.0,2,251,1.0,1.0,2,251,1.0,1.0,2,251,1.0,1.0
91,100,3,254,2,167,0.657,0.667,3,235,0.925,1.0,3,245,0.965,1.0,3,252,0.992,1.0,3,254,1.0,1.0,3,254,1.0,1.0,3,254,1.0,1.0
92,101,2,256,2,169,0.66,1.0,2,237,0.926,1.0,2,247,0.965,1.0,2,254,0.992,1.0,2,256,1.0,1.0,2,256,1.0,1.0,2,256,1.0,1.0
93,102,5,261,2,171,0.655,0.4,4,241,0.923,0.8,4,251,0.962,0.8,5,259,0.992,1.0,5,261,1.0,1.0,5,261,1.0,1.0,5,261,1.0,1.0
94,104,2,263,1,172,0.654,0.5,1,242,0.92,0.5,2,253,0.962,1.0,2,261,0.992,1.0,2,263,1.0,1.0,2,263,1.0,1.0,2,263,1.0,1.0
95,105,2,265,1,173,0.653,0.5,2,244,0.921,1.0,2,255,0.962,1.0,2,263,0.992,1.0,2,265,1.0,1.0,2,265,1.0,1.0,2,265,1.0,1.0
96,106,5,270,3,176,0.652,0.6,5,249,0.922,1.0,5,260,0.963,1.0,5,268,0.993,1.0,5,270,1.0,1.0,5,270,1.0,1.0,5,270,1.0,1.0
97,107,2,272,1,177,0.651,0.5,2,251,0.923,1.0,2,262,0.963,1.0,2,270,0.993,1.0,2,272,1.0,1.0,2,272,1.0,1.0,2,272,1.0,1.0
98,108,3,275,2,179,0.651,0.667,3,254,0.924,1.0,3,265,0.964,1.0,3,273,0.993,1.0,3,275,1.0,1.0,3,275,1.0,1.0,3,275,1.0,1.0
99,109,5,280,3,182,0.65,0.6,5,259,0.925,1.0,5,270,0.964,1.0,5,278,0.993,1.0,5,280,1.0,1.0,5,280,1.0,1.0,5,280,1.0,1.0
100,110,4,284,4,186,0.655,1.0,4,263,0.926,1.0,4,274,0.965,1.0,4,282,0.993,1.0,4,284,1.0,1.0,4,284,1.0,1.0,4,284,1.0,1.0
101,111,2,286,2,188,0.657,1.0,2,265,0.927,1.0,2,276,0.965,1.0,2,284,0.993,1.0,2,286,1.0,1.0,2,286,1.0,1.0,2,286,1.0,1.0
102,112,5,291,4,192,0.66,0.8,5,270,0.928,1.0,5,281,0.966,1.0,5,289,0.993,1.0,5,291,1.0,1.0,5,291,1.0,1.0,5,291,1.0,1.0
103,113,3,294,3,195,0.663,1.0,3,273,0.929,1.0,3,284,0.966,1.0,3,292,0.993,1.0,3,294,1.0,1.0,3,294,1.0,1.0,3,294,1.0,1.0
104,114,3,297,0,195,0.657,0.0,2,275,0.926,0.667,2,286,0.963,0.667,3,295,0.993,1.0,3,297,1.0,1.0,3,297,1.0,1.0,3,297,1.0,1.0
105,115,2,299,2,197,0.659,1.0,2,277,0.926,1.0,2,288,0.963,1.0,2,297,0.993,1.0,2,299,1.0,1.0,2,299,1.0,1.0,2,299,1.0,1.0
106,116,1,300,1,198,0.66,1.0,1,278,0.927,1.0,1,289,0.963,1.0,1,298,0.993,1.0,1,300,1.0,1.0,1,300,1.0,1.0,1,300,1.0,1.0
107,118,2,302,1,199,0.659,0.5,1,279,0.924,0.5,2,291,0.964,1.0,2,300,0.993,1.0,2,302,1.0,1.0,2,302,1.0,1.0,2,302,1.0,1.0
108,119,6,308,2,201,0.653,0.333,3,282,0.916,0.5,5,296,0.961,0.833,6,306,0.994,1.0,6,308,1.0,1.0,6,308,1.0,1.0,6,308,1.0,1.0
109,120,2,310,0,201,0.648,0.0,1,283,0.913,0.5,2,298,0.961,1.0,2,308,0.994,1.0,2,310,1.0,1.0,2,310,1.0,1.0,2,310,1.0,1.0
110,121,3,313,2,203,0.649,0.667,3,286,0.914,1.0,3,301,0.962,1.0,3,311,0.994,1.0,3,313,1.0,1.0,3,313,1.0,1.0,3,313,1.0,1.0
111,122,1,314,0,203,0.646,0.0,1,287,0.914,1.0,1,302,0.962,1.0,1,312,0.994,1.0,1,314,1.0,1.0,1,314,1.0,1.0,1,314,1.0,1.0
112,123,3,317,1,204,0.644,0.333,3,290,0.915,1.0,3,305,0.962,1.0,3,315,0.994,1.0,3,317,1.0,1.0,3,317,1.0,1.0,3,317,1.0,1.0
113,124,2,319,2,206,0.646,1.0,2,292,0.915,1.0,2,307,0.962,1.0,2,317,0.994,1.0,2,319,1.0,1.0,2,319,1.0,1.0,2,319,1.0,1.0
114,125,2,321,1,207,0.645,0.5,1,293,0.913,0.5,2,309,0.963,1.0,2,319,0.994,1.0,2,321,1.0,1.0,2,321,1.0,1.0,2,321,1.0,1.0
115,126,2,323,0,207,0.641,0.0,2,295,0.913,1.0,2,311,0.963,1.0,2,321,0.994,1.0,2,323,1.0,1.0,2,323,1.0,1.0,2,323,1.0,1.0
116,127,4,327,2,209,0.639,0.5,4,299,0.914,1.0,4,315,0.963,1.0,4,325,0.994,1.0,4,327,1.0,1.0,4,327,1.0,1.0,4,327,1.0,1.0
117,128,4,331,2,211,0.637,0.5,4,303,0.915,1.0,4,319,0.964,1.0,4,329,0.994,1.0,4,331,1.0,1.0,4,331,1.0,1.0,4,331,1.0,1.0
118,129,3,334,2,213,0.638,0.667,3,306,0.916,1.0,3,322,0.964,1.0,3,332,0.994,1.0,3,334,1.0,1.0,3,334,1.0,1.0,3,334,1.0,1.0
119,130,2,336,2,215,0.64,1.0,2,308,0.917,1.0,2,324,0.964,1.0,2,334,0.994,1.0,2,336,1.0,1.0,2,336,1.0,1.0,2,336,1.0,1.0
120,131,2,338,1,216,0.639,0.5,2,310,0.917,1.0,2,326,0.964,1.0,2,336,0.994,1.0,2,338,1.0,1.0,2,338,1.0,1.0,2,338,1.0,1.0
121,132,2,340,1,217,0.638,0.5,2,312,0.918,1.0,2,328,0.965,1.0,2,338,0.994,1.0,2,340,1.0,1.0,2,340,1.0,1.0,2,340,1.0,1.0
122,133,2,342,1,218,0.637,0.5,2,314,0.918,1.0,2,330,0.965,1.0,2,340,0.994,1.0,2,342,1.0,1.0,2,342,1.0,1.0,2,342,1.0,1.0
123,134,2,344,1,219,0.637,0.5,1,315,0.916,0.5,1,331,0.962,0.5,2,342,0.994,1.0,2,344,1.0,1.0,2,344,1.0,1.0,2,344,1.0,1.0
124,135,2,346,1,220,0.636,0.5,2,317,0.916,1.0,2,333,0.962,1.0,2,344,0.994,1.0,2,346,1.0,1.0,2,346,1.0,1.0,2,346,1.0,1.0
125,136,6,352,2,222,0.631,0.333,5,322,0.915,0.833,6,339,0.963,1.0,6,350,0.994,1.0,6,352,1.0,1.0,6,352,1.0,1.0,6,352,1.0,1.0
126,137,1,353,1,223,0.632,1.0,1,323,0.915,1.0,1,340,0.963,1.0,1,351,0.994,1.0,1,353,1.0,1.0,1,353,1.0,1.0,1,353,1.0,1.0
127,138,3,356,1,224,0.629,0.333,2,325,0.913,0.667,2,342,0.961,0.667,3,354,0.994,1.0,3,356,1.0,1.0,3,356,1.0,1.0,3,356,1.0,1.0
128,139,4,360,3,227,0.631,0.75,3,328,0.911,0.75,3,345,0.958,0.75,4,358,0.994,1.0,4,360,1.0,1.0,4,360,1.0,1.0,4,360,1.0,1.0
129,140,1,361,1,228,0.632,1.0,1,329,0.911,1.0,1,346,0.958,1.0,1,359,0.994,1.0,1,361,1.0,1.0,1,361,1.0,1.0,1,361,1.0,1.0
130,141,3,364,2,230,0.632,0.667,2,331,0.909,0.667,3,349,0.959,1.0,3,362,0.995,1.0,3,364,1.0,1.0,3,364,1.0,1.0,3,364,1.0,1.0
131,142,3,367,2,232,0.632,0.667,3,334,0.91,1.0,3,352,0.959,1.0,3,365,0.995,1.0,3,367,1.0,1.0,3,367,1.0,1.0,3,367,1.0,1.0
132,143,5,372,2,234,0.629,0.4,5,339,0.911,1.0,5,357,0.96,1.0,5,370,0.995,1.0,5,372,1.0,1.0,5,372,1.0,1.0,5,372,1.0,1.0
133,145,3,375,2,236,0.629,0.667,2,341,0.909,0.667,3,360,0.96,1.0,3,373,0.995,1.0,3,375,1.0,1.0,3,375,1.0,1.0,3,375,1.0,1.0
134,146,1,376,1,237,0.63,1.0,1,342,0.91,1.0,1,361,0.96,1.0,1,374,0.995,1.0,1,376,1.0,1.0,1,376,1.0,1.0,1,376,1.0,1.0
135,147,1,377,0,237,0.629,0.0,1,343,0.91,1.0,1,362,0.96,1.0,1,375,0.995,1.0,1,377,1.0,1.0,1,377,1.0,1.0,1,377,1.0,1.0
136,148,4,381,1,238,0.625,0.25,4,347,0.911,1.0,4,366,0.961,1.0,4,379,0.995,1.0,4,381,1.0,1.0,4,381,1.0,1.0,4,381,1.0,1.0
137,149,2,383,0,238,0.621,0.0,1,348,0.909,0.5,1,367,0.958,0.5,2,381,0.995,1.0,2,383,1.0,1.0,2,383,1.0,1.0,2,383,1.0,1.0
138,151,5,388,4,242,0.624,0.8,5,353,0.91,1.0,5,372,0.959,1.0,5,386,0.995,1.0,5,388,1.0,1.0,5,388,1.0,1.0,5,388,1.0,1.0
139,153,1,389,1,243,0.625,1.0,1,354,0.91,1.0,1,373,0.959,1.0,1,387,0.995,1.0,1,389,1.0,1.0,1,389,1.0,1.0,1,389,1.0,1.0
140,154,2,391,0,243,0.621,0.0,1,355,0.908,0.5,2,375,0.959,1.0,2,389,0.995,1.0,2,391,1.0,1.0,2,391,1.0,1.0,2,391,1.0,1.0
141,155,2,393,2,245,0.623,1.0,2,357,0.908,1.0,2,377,0.959,1.0,2,391,0.995,1.0,2,393,1.0,1.0,2,393,1.0,1.0,2,393,1.0,1.0
142,156,3,396,1,246,0.621,0.333,3,360,0.909,1.0,3,380,0.96,1.0,3,394,0.995,1.0,3,396,1.0,1.0,3,396,1.0,1.0,3,396,1.0,1.0
143,157,1,397,1,247,0.622,1.0,1,361,0.909,1.0,1,381,0.96,1.0,1,395,0.995,1.0,1,397,1.0,1.0,1,397,1.0,1.0,1,397,1.0,1.0
144,158,2,399,1,248,0.622,0.5,2,363,0.91,1.0,2,383,0.96,1.0,2,397,0.995,1.0,2,399,1.0,1.0,2,399,1.0,1.0,2,399,1.0,1.0
145,159,3,402,2,250,0.622,0.667,2,365,0.908,0.667,3,386,0.96,1.0,3,400,0.995,1.0,3,402,1.0,1.0,3,402,1.0,1.0,3,402,1.0,1.0
146,160,1,403,0,250,0.62,0.0,1,366,0.908,1.0,1,387,0.96,1.0,1,401,0.995,1.0,1,403,1.0,1.0,1,403,1.0,1.0,1,403,1.0,1.0
147,161,3,406,2,252,0.621,0.667,2,368,0.906,0.667,2,389,0.958,0.667,3,404,0.995,1.0,3,406,1.0,1.0,3,406,1.0,1.0,3,406,1.0,1.0
148,162,6,412,4,256,0.621,0.667,6,374,0.908,1.0,6,395,0.959,1.0,6,410,0.995,1.0,6,412,1.0,1.0,6,412,1.0,1.0,6,412,1.0,1.0
149,163,3,415,1,257,0.619,0.333,2,376,0.906,0.667,3,398,0.959,1.0,3,413,0.995,1.0,3,415,1.0,1.0,3,415,1.0,1.0,3,415,1.0,1.0
150,164,2,417,1,258,0.619,0.5,2,378,0.906,1.0,2,400,0.959,1.0,2,415,0.995,1.0,2,417,1.0,1.0,2,417,1.0,1.0,2,417,1.0,1.0
151,165,4,421,3,261,0.62,0.75,4,382,0.907,1.0,4,404,0.96,1.0,4,419,0.995,1.0,4,421,1.0,1.0,4,421,1.0,1.0,4,421,1.0,1.0
152,166,3,424,0,261,0.616,0.0,2,384,0.906,0.667,2,406,0.958,0.667,3,422,0.995,1.0,3,424,1.0,1.0,3,424,1.0,1.0,3,424,1.0,1.0
153,167,3,427,2,263,0.616,0.667,3,387,0.906,1.0,3,409,0.958,1.0,3,425,0.995,1.0,3,427,1.0,1.0,3,427,1.0,1.0,3,427,1.0,1.0
154,168,4,431,4,267,0.619,1.0,4,391,0.907,1.0,4,413,0.958,1.0,4,429,0.995,1.0,4,431,1.0,1.0,4,431,1.0,1.0,4,431,1.0,1.0
155,169,2,433,1,268,0.619,0.5,2,393,0.908,1.0,2,415,0.958,1.0,2,431,0.995,1.0,2,433,1.0,1.0,2,433,1.0,1.0,2,433,1.0,1.0
156,170,3,436,2,270,0.619,0.667,2,395,0.906,0.667,3,418,0.959,1.0,3,434,0.995,1.0,3,436,1.0,1.0,3,436,1.0,1.0,3,436,1.0,1.0
157,171,4,440,4,274,0.623,1.0,4,399,0.907,1.0,4,422,0.959,1.0,4,438,0.995,1.0,4,440,1.0,1.0,4,440,1.0,1.0,4,440,1.0,1.0
158,172,2,442,1,275,0.622,0.5,2,401,0.907,1.0,2,424,0.959,1.0,2,440,0.995,1.0,2,442,1.0,1.0,2,442,1.0,1.0,2,442,1.0,1.0
159,173,3,445,1,276,0.62,0.333,3,404,0.908,1.0,3,427,0.96,1.0,3,443,0.996,1.0,3,445,1.0,1.0,3,445,1.0,1.0,3,445,1.0,1.0
160,174,2,447,2,278,0.622,1.0,2,406,0.908,1.0,2,429,0.96,1.0,2,445,0.996,1.0,2,447,1.0,1.0,2,447,1.0,1.0,2,447,1.0,1.0
161,176,2,449,2,280,0.624,1.0,2,408,0.909,1.0,2,431,0.96,1.0,2,447,0.996,1.0,2,449,1.0,1.0,2,449,1.0,1.0,2,449,1.0,1.0
162,177,3,452,0,280,0.619,0.0,2,410,0.907,0.667,3,434,0.96,1.0,3,450,0.996,1.0,3,452,1.0,1.0,3,452,1.0,1.0,3,452,1.0,1.0
163,178,6,458,4,284,0.62,0.667,6,416,0.908,1.0,6,440,0.961,1.0,6,456,0.996,1.0,6,458,1.0,1.0,6,458,1.0,1.0,6,458,1.0,1.0
164,179,5,463,3,287,0.62,0.6,5,421,0.909,1.0,5,445,0.961,1.0,5,461,0.996,1.0,5,463,1.0,1.0,5,463,1.0,1.0,5,463,1.0,1.0
165,180,1,464,1,288,0.621,1.0,1,422,0.909,1.0,1,446,0.961,1.0,1,462,0.996,1.0,1,464,1.0,1.0,1,464,1.0,1.0,1,464,1.0,1.0
166,181,2,466,2,290,0.622,1.0,2,424,0.91,1.0,2,448,0.961,1.0,2,464,0.996,1.0,2,466,1.0,1.0,2,466,1.0,1.0,2,466,1.0,1.0
167,182,2,468,1,291,0.622,0.5,2,426,0.91,1.0,2,450,0.962,1.0,2,466,0.996,1.0,2,468,1.0,1.0,2,468,1.0,1.0,2,468,1.0,1.0
168,183,1,469,0,291,0.62,0.0,1,427,0.91,1.0,1,451,0.962,1.0,1,467,0.996,1.0,1,469,1.0,1.0,1,469,1.0,1.0,1,469,1.0,1.0
169,184,3,472,1,292,0.619,0.333,2,429,0.909,0.667,3,454,0.962,1.0,3,470,0.996,1.0,3,472,1.0,1.0,3,472,1.0,1.0,3,472,1.0,1.0
170,185,5,477,5,297,0.623,1.0,5,434,0.91,1.0,5,459,0.962,1.0,5,475,0.996,1.0,5,477,1.0,1.0,5,477,1.0,1.0,5,477,1.0,1.0
171,186,1,478,1,298,0.623,1.0,1,435,0.91,1.0,1,460,0.962,1.0,1,476,0.996,1.0,1,478,1.0,1.0,1,478,1.0,1.0,1,478,1.0,1.0
172,187,2,480,1,299,0.623,0.5,2,437,0.91,1.0,2,462,0.962,1.0,2,478,0.996,1.0,2,480,1.0,1.0,2,480,1.0,1.0,2,480,1.0,1.0
173,188,2,482,1,300,0.622,0.5,2,439,0.911,1.0,2,464,0.963,1.0,2,480,0.996,1.0,2,482,1.0,1.0,2,482,1.0,1.0,2,482,1.0,1.0
174,189,1,483,1,301,0.623,1.0,1,440,0.911,1.0,1,465,0.963,1.0,1,481,0.996,1.0,1,483,1.0,1.0,1,483,1.0,1.0,1,483,1.0,1.0
175,190,4,487,2,303,0.622,0.5,3,443,0.91,0.75,4,469,0.963,1.0,4,485,0.996,1.0,4,487,1.0,1.0,4,487,1.0,1.0,4,487,1.0,1.0
176,191,2,489,1,304,0.622,0.5,2,445,0.91,1.0,2,471,0.963,1.0,2,487,0.996,1.0,2,489,1.0,1.0,2,489,1.0,1.0,2,489,1.0,1.0
177,192,5,494,2,306,0.619,0.4,4,449,0.909,0.8,5,476,0.964,1.0,5,492,0.996,1.0,5,494,1.0,1.0,5,494,1.0,1.0,5,494,1.0,1.0
178,193,3,497,3,309,0.622,1.0,3,452,0.909,1.0,3,479,0.964,1.0,3,495,0.996,1.0,3,497,1.0,1.0,3,497,1.0,1.0,3,497,1.0,1.0
179,194,3,500,0,309,0.618,0.0,3,455,0.91,1.0,3,482,0.964,1.0,3,498,0.996,1.0,3,500,1.0,1.0,3,500,1.0,1.0,3,500,1.0,1.0
180,195,2,502,2,311,0.62,1.0,2,457,0.91,1.0,2,484,0.964,1.0,2,500,0.996,1.0,2,502,1.0,1.0,2,502,1.0,1.0,2,502,1.0,1.0
181,196,2,504,1,312,0.619,0.5,2,459,0.911,1.0,2,486,0.964,1.0,2,502,0.996,1.0,2,504,1.0,1.0,2,504,1.0,1.0,2,504,1.0,1.0
182,197,1,505,1,313,0.62,1.0,1,460,0.911,1.0,1,487,0.964,1.0,1,503,0.996,1.0,1,505,1.0,1.0,1,505,1.0,1.0,1,505,1.0,1.0
183,198,6,511,3,316,0.618,0.5,6,466,0.912,1.0,6,493,0.965,1.0,6,509,0.996,1.0,6,511,1.0,1.0,6,511,1.0,1.0,6,511,1.0,1.0
184,199,4,515,3,319,0.619,0.75,4,470,0.913,1.0,4,497,0.965,1.0,4,513,0.996,1.0,4,515,1.0,1.0,4,515,1.0,1.0,4,515,1.0,1.0
185,200,2,517,2,321,0.621,1.0,2,472,0.913,1.0,2,499,0.965,1.0,2,515,0.996,1.0,2,517,1.0,1.0,2,517,1.0,1.0,2,517,1.0,1.0
186,202,2,519,1,322,0.62,0.5,2,474,0.913,1.0,2,501,0.965,1.0,2,517,0.996,1.0,2,519,1.0,1.0,2,519,1.0,1.0,2,519,1.0,1.0
187,203,2,521,0,322,0.618,0.0,2,476,0.914,1.0,2,503,0.965,1.0,2,519,0.996,1.0,2,521,1.0,1.0,2,521,1.0,1.0,2,521,1.0,1.0
188,204,4,525,3,325,0.619,0.75,3,479,0.912,0.75,4,507,0.966,1.0,4,523,0.996,1.0,4,525,1.0,1.0,4,525,1.0,1.0,4,525,1.0,1.0
189,205,5,530,5,330,0.623,1.0,5,484,0.913,1.0,5,512,0.966,1.0,5,528,0.996,1.0,5,530,1.0,1.0,5,530,1.0,1.0,5,530,1.0,1.0
190,206,5,535,3,333,0.622,0.6,4,488,0.912,0.8,4,516,0.964,0.8,5,533,0.996,1.0,5,535,1.0,1.0,5,535,1.0,1.0,5,535,1.0,1.0
191,207,3,538,2,335,0.623,0.667,3,491,0.913,1.0,3,519,0.965,1.0,3,536,0.996,1.0,3,538,1.0,1.0,3,538,1.0,1.0,3,538,1.0,1.0
192,208,7,545,4,339,0.622,0.571,7,498,0.914,1.0,7,526,0.965,1.0,7,543,0.996,1.0,7,545,1.0,1.0,7,545,1.0,1.0,7,545,1.0,1.0
193,209,3,548,1,340,0.62,0.333,1,499,0.911,0.333,3,529,0.965,1.0,3,546,0.996,1.0,3,548,1.0,1.0,3,548,1.0,1.0,3,548,1.0,1.0
194,210,1,549,1,341,0.621,1.0,1,500,0.911,1.0,1,530,0.965,1.0,1,547,0.996,1.0,1,549,1.0,1.0,1,549,1.0,1.0,1,549,1.0,1.0
195,211,4,553,2,343,0.62,0.5,3,503,0.91,0.75,3,533,0.964,0.75,4,551,0.996,1.0,4,553,1.0,1.0,4,553,1.0,1.0,4,553,1.0,1.0
196,212,2,555,1,344,0.62,0.5,2,505,0.91,1.0,2,535,0.964,1.0,2,553,0.996,1.0,2,555,1.0,1.0,2,555,1.0,1.0,2,555,1.0,1.0
197,213,2,557,0,344,0.618,0.0,1,506,0.908,0.5,2,537,0.964,1.0,2,555,0.996,1.0,2,557,1.0,1.0,2,557,1.0,1.0,2,557,1.0,1.0
198,214,2,559,2,346,0.619,1.0,2,508,0.909,1.0,2,539,0.964,1.0,2,557,0.996,1.0,2,559,1.0,1.0,2,559,1.0,1.0,2,559,1.0,1.0
199,215,3,562,3,349,0.621,1.0,3,511,0.909,1.0,3,542,0.964,1.0,3,560,0.996,1.0,3,562,1.0,1.0,3,562,1.0,1.0,3,562,1.0,1.0
200,216,1,563,1,350,0.622,1.0,1,512,0.909,1.0,1,543,0.964,1.0,1,561,0.996,1.0,1,563,1.0,1.0,1,563,1.0,1.0,1,563,1.0,1.0
201,217,5,568,2,352,0.62,0.4,4,516,0.908,0.8,4,547,0.963,0.8,4,565,0.995,0.8,5,568,1.0,1.0,5,568,1.0,1.0,5,568,1.0,1.0
202,218,3,571,2,354,0.62,0.667,3,519,0.909,1.0,3,550,0.963,1.0,3,568,0.995,1.0,3,571,1.0,1.0,3,571,1.0,1.0,3,571,1.0,1.0
203,219,3,574,0,354,0.617,0.0,1,520,0.906,0.333,2,552,0.962,0.667,2,570,0.993,0.667,3,574,1.0,1.0,3,574,1.0,1.0,3,574,1.0,1.0
204,220,2,576,2,356,0.618,1.0,2,522,0.906,1.0,2,554,0.962,1.0,2,572,0.993,1.0,2,576,1.0,1.0,2,576,1.0,1.0,2,576,1.0,1.0
205,221,2,578,1,357,0.618,0.5,2,524,0.907,1.0,2,556,0.962,1.0,2,574,0.993,1.0,2,578,1.0,1.0,2,578,1.0,1.0,2,578,1.0,1.0
206,222,1,579,0,357,0.617,0.0,0,524,0.905,0.0,1,557,0.962,1.0,1,575,0.993,1.0,1,579,1.0,1.0,1,579,1.0,1.0,1,579,1.0,1.0
207,223,3,582,3,360,0.619,1.0,3,527,0.905,1.0,3,560,0.962,1.0,3,578,0.993,1.0,3,582,1.0,1.0,3,582,1.0,1.0,3,582,1.0,1.0
208,224,2,584,0,360,0.616,0.0,2,529,0.906,1.0,2,562,0.962,1.0,2,580,0.993,1.0,2,584,1.0,1.0,2,584,1.0,1.0,2,584,1.0,1.0
209,225,4,588,2,362,0.616,0.5,3,532,0.905,0.75,3,565,0.961,0.75,3,583,0.991,0.75,3,587,0.998,0.75,4,588,1.0,1.0,4,588,1.0,1.0
210,226,2,590,1,363,0.615,0.5,2,534,0.905,1.0,2,567,0.961,1.0,2,585,0.992,1.0,2,589,0.998,1.0,2,590,1.0,1.0,2,590,1.0,1.0
211,227,4,594,2,365,0.614,0.5,4,538,0.906,1.0,4,571,0.961,1.0,4,589,0.992,1.0,4,593,0.998,1.0,4,594,1.0,1.0,4,594,1.0,1.0
212,229,2,596,1,366,0.614,0.5,2,540,0.906,1.0,2,573,0.961,1.0,2,591,0.992,1.0,2,595,0.998,1.0,2,596,1.0,1.0,2,596,1.0,1.0
213,231,2,598,1,367,0.614,0.5,2,542,0.906,1.0,2,575,0.962,1.0,2,593,0.992,1.0,2,597,0.998,1.0,2,598,1.0,1.0,2,598,1.0,1.0
214,232,3,601,1,368,0.612,0.333,2,544,0.905,0.667,2,577,0.96,0.667,3,596,0.992,1.0,3,600,0.998,1.0,3,601,1.0,1.0,3,601,1.0,1.0
215,233,2,603,1,369,0.612,0.5,2,546,0.905,1.0,2,579,0.96,1.0,2,598,0.992,1.0,2,602,0.998,1.0,2,603,1.0,1.0,2,603,1.0,1.0
216,235,4,607,3,372,0.613,0.75,4,550,0.906,1.0,4,583,0.96,1.0,4,602,0.992,1.0,4,606,0.998,1.0,4,607,1.0,1.0,4,607,1.0,1.0
217,236,1,608,0,372,0.612,0.0,1,551,0.906,1.0,1,584,0.961,1.0,1,603,0.992,1.0,1,607,0.998,1.0,1,608,1.0,1.0,1,608,1.0,1.0
218,237,3,611,3,375,0.614,1.0,3,554,0.907,1.0,3,587,0.961,1.0,3,606,0.992,1.0,3,610,0.998,1.0,3,611,1.0,1.0,3,611,1.0,1.0
219,238,2,613,0,375,0.612,0.0,1,555,0.905,0.5,1,588,0.959,0.5,1,607,0.99,0.5,2,612,0.998,1.0,2,613,1.0,1.0,2,613,1.0,1.0
220,239,1,614,1,376,0.612,1.0,1,556,0.906,1.0,1,589,0.959,1.0,1,608,0.99,1.0,1,613,0.998,1.0,1,614,1.0,1.0,1,614,1.0,1.0
221,240,1,615,0,376,0.611,0.0,1,557,0.906,1.0,1,590,0.959,1.0,1,609,0.99,1.0,1,614,0.998,1.0,1,615,1.0,1.0,1,615,1.0,1.0
222,241,3,618,1,377,0.61,0.333,3,560,0.906,1.0,3,593,0.96,1.0,3,612,0.99,1.0,3,617,0.998,1.0,3,618,1.0,1.0,3,618,1.0,1.0
223,242,2,620,1,378,0.61,0.5,2,562,0.906,1.0,2,595,0.96,1.0,2,614,0.99,1.0,2,619,0.998,1.0,2,620,1.0,1.0,2,620,1.0,1.0
224,243,1,621,0,378,0.609,0.0,1,563,0.907,1.0,1,596,0.96,1.0,1,615,0.99,1.0,1,620,0.998,1.0,1,621,1.0,1.0,1,621,1.0,1.0
225,244,1,622,0,378,0.608,0.0,0,563,0.905,0.0,0,596,0.958,0.0,1,616,0.99,1.0,1,621,0.998,1.0,1,622,1.0,1.0,1,622,1.0,1.0
226,245,1,623,0,378,0.607,0.0,0,563,0.904,0.0,0,596,0.957,0.0,1,617,0.99,1.0,1,622,0.998,1.0,1,623,1.0,1.0,1,623,1.0,1.0
227,246,3,626,1,379,0.605,0.333,2,565,0.903,0.667,2,598,0.955,0.667,3,620,0.99,1.0,3,625,0.998,1.0,3,626,1.0,1.0,3,626,1.0,1.0
228,247,1,627,0,379,0.604,0.0,1,566,0.903,1.0,1,599,0.955,1.0,1,621,0.99,1.0,1,626,0.998,1.0,1,627,1.0,1.0,1,627,1.0,1.0
229,248,3,630,0,379,0.602,0.0,1,567,0.9,0.333,1,600,0.952,0.333,3,624,0.99,1.0,3,629,0.998,1.0,3,630,1.0,1.0,3,630,1.0,1.0
230,249,3,633,1,380,0.6,0.333,3,570,0.9,1.0,3,603,0.953,1.0,3,627,0.991,1.0,3,632,0.998,1.0,3,633,1.0,1.0,3,633,1.0,1.0
231,250,2,635,1,381,0.6,0.5,1,571,0.899,0.5,2,605,0.953,1.0,2,629,0.991,1.0,2,634,0.998,1.0,2,635,1.0,1.0,2,635,1.0,1.0
232,251,3,638,1,382,0.599,0.333,2,573,0.898,0.667,2,607,0.951,0.667,2,631,0.989,0.667,3,637,0.998,1.0,3,638,1.0,1.0,3,638,1.0,1.0
233,252,3,641,1,383,0.598,0.333,1,574,0.895,0.333,1,608,0.949,0.333,3,634,0.989,1.0,3,640,0.998,1.0,3,641,1.0,1.0,3,641,1.0,1.0
234,253,2,643,2,385,0.599,1.0,2,576,0.896,1.0,2,610,0.949,1.0,2,636,0.989,1.0,2,642,0.998,1.0,2,643,1.0,1.0,2,643,1.0,1.0
235,254,2,645,0,385,0.597,0.0,2,578,0.896,1.0,2,612,0.949,1.0,2,638,0.989,1.0,2,644,0.998,1.0,2,645,1.0,1.0,2,645,1.0,1.0
236,255,2,647,0,385,0.595,0.0,1,579,0.895,0.5,2,614,0.949,1.0,2,640,0.989,1.0,2,646,0.998,1.0,2,647,1.0,1.0,2,647,1.0,1.0
237,257,1,648,1,386,0.596,1.0,1,580,0.895,1.0,1,615,0.949,1.0,1,641,0.989,1.0,1,647,0.998,1.0,1,648,1.0,1.0,1,648,1.0,1.0
238,258,2,650,1,387,0.595,0.5,1,581,0.894,0.5,2,617,0.949,1.0,2,643,0.989,1.0,2,649,0.998,1.0,2,650,1.0,1.0,2,650,1.0,1.0
239,259,5,655,4,391,0.597,0.8,5,586,0.895,1.0,5,622,0.95,1.0,5,648,0.989,1.0,5,654,0.998,1.0,5,655,1.0,1.0,5,655,1.0,1.0
240,260,2,657,2,393,0.598,1.0,2,588,0.895,1.0,2,624,0.95,1.0,2,650,0.989,1.0,2,656,0.998,1.0,2,657,1.0,1.0,2,657,1.0,1.0
241,261,2,659,1,394,0.598,0.5,2,590,0.895,1.0,2,626,0.95,1.0,2,652,0.989,1.0,2,658,0.998,1.0,2,659,1.0,1.0,2,659,1.0,1.0
242,262,2,661,1,395,0.598,0.5,2,592,0.896,1.0,2,628,0.95,1.0,2,654,0.989,1.0,2,660,0.998,1.0,2,661,1.0,1.0,2,661,1.0,1.0
243,265,4,665,3,398,0.598,0.75,4,596,0.896,1.0,4,632,0.95,1.0,4,658,0.989,1.0,4,664,0.998,1.0,4,665,1.0,1.0,4,665,1.0,1.0
244,266,3,668,2,400,0.599,0.667,2,598,0.895,0.667,2,634,0.949,0.667,2,660,0.988,0.667,3,667,0.999,1.0,3,668,1.0,1.0,3,668,1.0,1.0
245,267,1,669,0,400,0.598,0.0,0,598,0.894,0.0,0,634,0.948,0.0,1,661,0.988,1.0,1,668,0.999,1.0,1,669,1.0,1.0,1,669,1.0,1.0
246,268,3,672,2,402,0.598,0.667,3,601,0.894,1.0,3,637,0.948,1.0,3,664,0.988,1.0,3,671,0.999,1.0,3,672,1.0,1.0,3,672,1.0,1.0
247,269,5,677,3,405,0.598,0.6,3,604,0.892,0.6,5,642,0.948,1.0,5,669,0.988,1.0,5,676,0.999,1.0,5,677,1.0,1.0,5,677,1.0,1.0
248,271,1,678,0,405,0.597,0.0,1,605,0.892,1.0,1,643,0.948,1.0,1,670,0.988,1.0,1,677,0.999,1.0,1,678,1.0,1.0,1,678,1.0,1.0
249,272,2,680,0,405,0.596,0.0,1,606,0.891,0.5,1,644,0.947,0.5,2,672,0.988,1.0,2,679,0.999,1.0,2,680,1.0,1.0,2,680,1.0,1.0
250,273,3,683,3,408,0.597,1.0,3,609,0.892,1.0,3,647,0.947,1.0,3,675,0.988,1.0,3,682,0.999,1.0,3,683,1.0,1.0,3,683,1.0,1.0
251,274,4,687,1,409,0.595,0.25,2,611,0.889,0.5,4,651,0.948,1.0,4,679,0.988,1.0,4,686,0.999,1.0,4,687,1.0,1.0,4,687,1.0,1.0
252,275,7,694,3,412,0.594,0.429,7,618,0.89,1.0,7,658,0.948,1.0,7,686,0.988,1.0,7,693,0.999,1.0,7,694,1.0,1.0,7,694,1.0,1.0
253,276,2,696,1,413,0.593,0.5,1,619,0.889,0.5,2,660,0.948,1.0,2,688,0.989,1.0,2,695,0.999,1.0,2,696,1.0,1.0,2,696,1.0,1.0
254,277,2,698,1,414,0.593,0.5,2,621,0.89,1.0,2,662,0.948,1.0,2,690,0.989,1.0,2,697,0.999,1.0,2,698,1.0,1.0,2,698,1.0,1.0
255,278,2,700,1,415,0.593,0.5,2,623,0.89,1.0,2,664,0.949,1.0,2,692,0.989,1.0,2,699,0.999,1.0,2,700,1.0,1.0,2,700,1.0,1.0
256,279,4,704,2,417,0.592,0.5,2,625,0.888,0.5,2,666,0.946,0.5,3,695,0.987,0.75,4,703,0.999,1.0,4,704,1.0,1.0,4,704,1.0,1.0
257,280,1,705,0,417,0.591,0.0,1,626,0.888,1.0,1,667,0.946,1.0,1,696,0.987,1.0,1,704,0.999,1.0,1,705,1.0,1.0,1,705,1.0,1.0
258,281,1,706,0,417,0.591,0.0,1,627,0.888,1.0,1,668,0.946,1.0,1,697,0.987,1.0,1,705,0.999,1.0,1,706,1.0,1.0,1,706,1.0,1.0
259,282,4,710,1,418,0.589,0.25,3,630,0.887,0.75,3,671,0.945,0.75,3,700,0.986,0.75,4,709,0.999,1.0,4,710,1.0,1.0,4,710,1.0,1.0
260,283,1,711,0,418,0.588,0.0,1,631,0.887,1.0,1,672,0.945,1.0,1,701,0.986,1.0,1,710,0.999,1.0,1,711,1.0,1.0,1,711,1.0,1.0
261,285,2,713,1,419,0.588,0.5,1,632,0.886,0.5,1,673,0.944,0.5,2,703,0.986,1.0,2,712,0.999,1.0,2,713,1.0,1.0,2,713,1.0,1.0
262,286,2,715,1,420,0.587,0.5,2,634,0.887,1.0,2,675,0.944,1.0,2,705,0.986,1.0,2,714,0.999,1.0,2,715,1.0,1.0,2,715,1.0,1.0
263,287,1,716,1,421,0.588,1.0,1,635,0.887,1.0,1,676,0.944,1.0,1,706,0.986,1.0,1,715,0.999,1.0,1,716,1.0,1.0,1,716,1.0,1.0
264,288,1,717,0,421,0.587,0.0,1,636,0.887,1.0,1,677,0.944,1.0,1,707,0.986,1.0,1,716,0.999,1.0,1,717,1.0,1.0,1,717,1.0,1.0
265,289,1,718,0,421,0.586,0.0,1,637,0.887,1.0,1,678,0.944,1.0,1,708,0.986,1.0,1,717,0.999,1.0,1,718,1.0,1.0,1,718,1.0,1.0
266,290,2,720,1,422,0.586,0.5,2,639,0.888,1.0,2,680,0.944,1.0,2,710,0.986,1.0,2,719,0.999,1.0,2,720,1.0,1.0,2,720,1.0,1.0
267,291,2,722,1,423,0.586,0.5,1,640,0.886,0.5,1,681,0.943,0.5,2,712,0.986,1.0,2,721,0.999,1.0,2,722,1.0,1.0,2,722,1.0,1.0
268,292,2,724,0,423,0.584,0.0,2,642,0.887,1.0,2,683,0.943,1.0,2,714,0.986,1.0,2,723,0.999,1.0,2,724,1.0,1.0,2,724,1.0,1.0
269,294,4,728,2,425,0.584,0.5,3,645,0.886,0.75,4,687,0.944,1.0,4,718,0.986,1.0,4,727,0.999,1.0,4,728,1.0,1.0,4,728,1.0,1.0
270,295,3,731,1,426,0.583,0.333,3,648,0.886,1.0,3,690,0.944,1.0,3,721,0.986,1.0,3,730,0.999,1.0,3,731,1.0,1.0,3,731,1.0,1.0
271,296,3,734,1,427,0.582,0.333,2,650,0.886,0.667,2,692,0.943,0.667,3,724,0.986,1.0,3,733,0.999,1.0,3,734,1.0,1.0,3,734,1.0,1.0
272,297,2,736,1,428,0.582,0.5,1,651,0.885,0.5,2,694,0.943,1.0,2,726,0.986,1.0,2,735,0.999,1.0,2,736,1.0,1.0,2,736,1.0,1.0
273,298,2,738,1,429,0.581,0.5,2,653,0.885,1.0,2,696,0.943,1.0,2,728,0.986,1.0,2,737,0.999,1.0,2,738,1.0,1.0,2,738,1.0,1.0
274,299,1,739,1,430,0.582,1.0,1,654,0.885,1.0,1,697,0.943,1.0,1,729,0.986,1.0,1,738,0.999,1.0,1,739,1.0,1.0,1,739,1.0,1.0
275,300,1,740,0,430,0.581,0.0,1,655,0.885,1.0,1,698,0.943,1.0,1,730,0.986,1.0,1,739,0.999,1.0,1,740,1.0,1.0,1,740,1.0,1.0
276,301,4,744,1,431,0.579,0.25,3,658,0.884,0.75,4,702,0.944,1.0,4,734,0.987,1.0,4,743,0.999,1.0,4,744,1.0,1.0,4,744,1.0,1.0
277,302,6,750,3,434,0.579,0.5,4,662,0.883,0.667,5,707,0.943,0.833,6,740,0.987,1.0,6,749,0.999,1.0,6,750,1.0,1.0,6,750,1.0,1.0
278,303,5,755,2,436,0.577,0.4,4,666,0.882,0.8,5,712,0.943,1.0,5,745,0.987,1.0,5,754,0.999,1.0,5,755,1.0,1.0,5,755,1.0,1.0
279,304,1,756,0,436,0.577,0.0,1,667,0.882,1.0,1,713,0.943,1.0,1,746,0.987,1.0,1,755,0.999,1.0,1,756,1.0,1.0,1,756,1.0,1.0
280,305,4,760,1,437,0.575,0.25,1,668,0.879,0.25,4,717,0.943,1.0,4,750,0.987,1.0,4,759,0.999,1.0,4,760,1.0,1.0,4,760,1.0,1.0
281,307,1,761,0,437,0.574,0.0,0,668,0.878,0.0,0,717,0.942,0.0,1,751,0.987,1.0,1,760,0.999,1.0,1,761,1.0,1.0,1,761,1.0,1.0
282,308,1,762,0,437,0.573,0.0,1,669,0.878,1.0,1,718,0.942,1.0,1,752,0.987,1.0,1,761,0.999,1.0,1,762,1.0,1.0,1,762,1.0,1.0
283,310,2,764,2,439,0.575,1.0,2,671,0.878,1.0,2,720,0.942,1.0,2,754,0.987,1.0,2,763,0.999,1.0,2,764,1.0,1.0,2,764,1.0,1.0
284,311,1,765,1,440,0.575,1.0,1,672,0.878,1.0,1,721,0.942,1.0,1,755,0.987,1.0,1,764,0.999,1.0,1,765,1.0,1.0,1,765,1.0,1.0
285,312,4,769,1,441,0.573,0.25,4,676,0.879,1.0,4,725,0.943,1.0,4,759,0.987,1.0,4,768,0.999,1.0,4,769,1.0,1.0,4,769,1.0,1.0
286,313,2,771,2,443,0.575,1.0,2,678,0.879,1.0,2,727,0.943,1.0,2,761,0.987,1.0,2,770,0.999,1.0,2,771,1.0,1.0,2,771,1.0,1.0
287,314,4,775,2,445,0.574,0.5,3,681,0.879,0.75,4,731,0.943,1.0,4,765,0.987,1.0,4,774,0.999,1.0,4,775,1.0,1.0,4,775,1.0,1.0
288,315,3,778,3,448,0.576,1.0,3,684,0.879,1.0,3,734,0.943,1.0,3,768,0.987,1.0,3,777,0.999,1.0,3,778,1.0,1.0,3,778,1.0,1.0
289,316,1,779,0,448,0.575,0.0,0,684,0.878,0.0,0,734,0.942,0.0,1,769,0.987,1.0,1,778,0.999,1.0,1,779,1.0,1.0,1,779,1.0,1.0
290,317,3,782,1,449,0.574,0.333,3,687,0.879,1.0,3,737,0.942,1.0,3,772,0.987,1.0,3,781,0.999,1.0,3,782,1.0,1.0,3,782,1.0,1.0
291,319,2,784,0,449,0.573,0.0,1,688,0.878,0.5,1,738,0.941,0.5,2,774,0.987,1.0,2,783,0.999,1.0,2,784,1.0,1.0,2,784,1.0,1.0
292,320,4,788,2,451,0.572,0.5,3,691,0.877,0.75,4,742,0.942,1.0,4,778,0.987,1.0,4,787,0.999,1.0,4,788,1.0,1.0,4,788,1.0,1.0
293,321,5,793,0,451,0.569,0.0,2,693,0.874,0.4,3,745,0.939,0.6,5,783,0.987,1.0,5,792,0.999,1.0,5,793,1.0,1.0,5,793,1.0,1.0
294,322,3,796,0,451,0.567,0.0,2,695,0.873,0.667,2,747,0.938,0.667,3,786,0.987,1.0,3,795,0.999,1.0,3,796,1.0,1.0,3,796,1.0,1.0
295,323,5,801,3,454,0.567,0.6,3,698,0.871,0.6,5,752,0.939,1.0,5,791,0.988,1.0,5,800,0.999,1.0,5,801,1.0,1.0,5,801,1.0,1.0
296,324,1,802,1,455,0.567,1.0,1,699,0.872,1.0,1,753,0.939,1.0,1,792,0.988,1.0,1,801,0.999,1.0,1,802,1.0,1.0,1,802,1.0,1.0
297,325,3,805,3,458,0.569,1.0,3,702,0.872,1.0,3,756,0.939,1.0,3,795,0.988,1.0,3,804,0.999,1.0,3,805,1.0,1.0,3,805,1.0,1.0
298,326,5,810,3,461,0.569,0.6,5,707,0.873,1.0,5,761,0.94,1.0,5,800,0.988,1.0,5,809,0.999,1.0,5,810,1.0,1.0,5,810,1.0,1.0
299,327,1,811,1,462,0.57,1.0,1,708,0.873,1.0,1,762,0.94,1.0,1,801,0.988,1.0,1,810,0.999,1.0,1,811,1.0,1.0,1,811,1.0,1.0
300,328,2,813,1,463,0.569,0.5,2,710,0.873,1.0,2,764,0.94,1.0,2,803,0.988,1.0,2,812,0.999,1.0,2,813,1.0,1.0,2,813,1.0,1.0
301,329,3,816,2,465,0.57,0.667,2,712,0.873,0.667,2,766,0.939,0.667,2,805,0.987,0.667,3,815,0.999,1.0,3,816,1.0,1.0,3,816,1.0,1.0
302,331,1,817,0,465,0.569,0.0,0,712,0.871,0.0,0,766,0.938,0.0,1,806,0.987,1.0,1,816,0.999,1.0,1,817,1.0,1.0,1,817,1.0,1.0
303,332,1,818,1,466,0.57,1.0,1,713,0.872,1.0,1,767,0.938,1.0,1,807,0.987,1.0,1,817,0.999,1.0,1,818,1.0,1.0,1,818,1.0,1.0
304,333,1,819,1,467,0.57,1.0,1,714,0.872,1.0,1,768,0.938,1.0,1,808,0.987,1.0,1,818,0.999,1.0,1,819,1.0,1.0,1,819,1.0,1.0
305,334,1,820,1,468,0.571,1.0,1,715,0.872,1.0,1,769,0.938,1.0,1,809,0.987,1.0,1,819,0.999,1.0,1,820,1.0,1.0,1,820,1.0,1.0
306,335,1,821,0,468,0.57,0.0,1,716,0.872,1.0,1,770,0.938,1.0,1,810,0.987,1.0,1,820,0.999,1.0,1,821,1.0,1.0,1,821,1.0,1.0
307,336,2,823,1,469,0.57,0.5,2,718,0.872,1.0,2,772,0.938,1.0,2,812,0.987,1.0,2,822,0.999,1.0,2,823,1.0,1.0,2,823,1.0,1.0
308,337,1,824,1,470,0.57,1.0,1,719,0.873,1.0,1,773,0.938,1.0,1,813,0.987,1.0,1,823,0.999,1.0,1,824,1.0,1.0,1,824,1.0,1.0
309,338,1,825,0,470,0.57,0.0,1,720,0.873,1.0,1,774,0.938,1.0,1,814,0.987,1.0,1,824,0.999,1.0,1,825,1.0,1.0,1,825,1.0,1.0
310,339,3,828,1,471,0.569,0.333,1,721,0.871,0.333,3,777,0.938,1.0,3,817,0.987,1.0,3,827,0.999,1.0,3,828,1.0,1.0,3,828,1.0,1.0
311,340,2,830,0,471,0.567,0.0,2,723,0.871,1.0,2,779,0.939,1.0,2,819,0.987,1.0,2,829,0.999,1.0,2,830,1.0,1.0,2,830,1.0,1.0
312,341,5,835,1,472,0.565,0.2,4,727,0.871,0.8,5,784,0.939,1.0,5,824,0.987,1.0,5,834,0.999,1.0,5,835,1.0,1.0,5,835,1.0,1.0
313,342,1,836,1,473,0.566,1.0,1,728,0.871,1.0,1,785,0.939,1.0,1,825,0.987,1.0,1,835,0.999,1.0,1,836,1.0,1.0,1,836,1.0,1.0
314,343,1,837,1,474,0.566,1.0,1,729,0.871,1.0,1,786,0.939,1.0,1,826,0.987,1.0,1,836,0.999,1.0,1,837,1.0,1.0,1,837,1.0,1.0
315,344,3,840,0,474,0.564,0.0,1,730,0.869,0.333,1,787,0.937,0.333,3,829,0.987,1.0,3,839,0.999,1.0,3,840,1.0,1.0,3,840,1.0,1.0
316,345,3,843,1,475,0.563,0.333,2,732,0.868,0.667,3,790,0.937,1.0,3,832,0.987,1.0,3,842,0.999,1.0,3,843,1.0,1.0,3,843,1.0,1.0
317,347,1,844,1,476,0.564,1.0,1,733,0.868,1.0,1,791,0.937,1.0,1,833,0.987,1.0,1,843,0.999,1.0,1,844,1.0,1.0,1,844,1.0,1.0
318,349,3,847,0,476,0.562,0.0,1,734,0.867,0.333,1,792,0.935,0.333,3,836,0.987,1.0,3,846,0.999,1.0,3,847,1.0,1.0,3,847,1.0,1.0
319,350,2,849,1,477,0.562,0.5,2,736,0.867,1.0,2,794,0.935,1.0,2,838,0.987,1.0,2,848,0.999,1.0,2,849,1.0,1.0,2,849,1.0,1.0
320,352,1,850,1,478,0.562,1.0,1,737,0.867,1.0,1,795,0.935,1.0,1,839,0.987,1.0,1,849,0.999,1.0,1,850,1.0,1.0,1,850,1.0,1.0
321,353,3,853,1,479,0.562,0.333,3,740,0.868,1.0,3,798,0.936,1.0,3,842,0.987,1.0,3,852,0.999,1.0,3,853,1.0,1.0,3,853,1.0,1.0
322,354,2,855,1,480,0.561,0.5,1,741,0.867,0.5,2,800,0.936,1.0,2,844,0.987,1.0,2,854,0.999,1.0,2,855,1.0,1.0,2,855,1.0,1.0
323,355,1,856,0,480,0.561,0.0,0,741,0.866,0.0,0,800,0.935,0.0,1,845,0.987,1.0,1,855,0.999,1.0,1,856,1.0,1.0,1,856,1.0,1.0
324,356,1,857,0,480,0.56,0.0,1,742,0.866,1.0,1,801,0.935,1.0,1,846,0.987,1.0,1,856,0.999,1.0,1,857,1.0,1.0,1,857,1.0,1.0
325,357,1,858,0,480,0.559,0.0,0,742,0.865,0.0,0,801,0.934,0.0,1,847,0.987,1.0,1,857,0.999,1.0,1,858,1.0,1.0,1,858,1.0,1.0
326,358,2,860,2,482,0.56,1.0,2,744,0.865,1.0,2,803,0.934,1.0,2,849,0.987,1.0,2,859,0.999,1.0,2,860,1.0,1.0,2,860,1.0,1.0
327,359,1,861,0,482,0.56,0.0,0,744,0.864,0.0,0,803,0.933,0.0,1,850,0.987,1.0,1,860,0.999,1.0,1,861,1.0,1.0,1,861,1.0,1.0
328,360,2,863,2,484,0.561,1.0,2,746,0.864,1.0,2,805,0.933,1.0,2,852,0.987,1.0,2,862,0.999,1.0,2,863,1.0,1.0,2,863,1.0,1.0
329,361,1,864,1,485,0.561,1.0,1,747,0.865,1.0,1,806,0.933,1.0,1,853,0.987,1.0,1,863,0.999,1.0,1,864,1.0,1.0,1,864,1.0,1.0
330,362,1,865,0,485,0.561,0.0,0,747,0.864,0.0,1,807,0.933,1.0,1,854,0.987,1.0,1,864,0.999,1.0,1,865,1.0,1.0,1,865,1.0,1.0
331,363,1,866,1,486,0.561,1.0,1,748,0.864,1.0,1,808,0.933,1.0,1,855,0.987,1.0,1,865,0.999,1.0,1,866,1.0,1.0,1,866,1.0,1.0
332,364,2,868,0,486,0.56,0.0,1,749,0.863,0.5,1,809,0.932,0.5,2,857,0.987,1.0,2,867,0.999,1.0,2,868,1.0,1.0,2,868,1.0,1.0
333,365,1,869,0,486,0.559,0.0,1,750,0.863,1.0,1,810,0.932,1.0,1,858,0.987,1.0,1,868,0.999,1.0,1,869,1.0,1.0,1,869,1.0,1.0
334,366,5,874,1,487,0.557,0.2,4,754,0.863,0.8,4,814,0.931,0.8,5,863,0.987,1.0,5,873,0.999,1.0,5,874,1.0,1.0,5,874,1.0,1.0
335,367,2,876,1,488,0.557,0.5,2,756,0.863,1.0,2,816,0.932,1.0,2,865,0.987,1.0,2,875,0.999,1.0,2,876,1.0,1.0,2,876,1.0,1.0
336,369,1,877,0,488,0.556,0.0,0,756,0.862,0.0,0,816,0.93,0.0,1,866,0.987,1.0,1,876,0.999,1.0,1,877,1.0,1.0,1,877,1.0,1.0
337,370,2,879,1,489,0.556,0.5,2,758,0.862,1.0,2,818,0.931,1.0,2,868,0.987,1.0,2,878,0.999,1.0,2,879,1.0,1.0,2,879,1.0,1.0
338,371,3,882,1,490,0.556,0.333,3,761,0.863,1.0,3,821,0.931,1.0,3,871,0.988,1.0,3,881,0.999,1.0,3,882,1.0,1.0,3,882,1.0,1.0
339,372,1,883,0,490,0.555,0.0,1,762,0.863,1.0,1,822,0.931,1.0,1,872,0.988,1.0,1,882,0.999,1.0,1,883,1.0,1.0,1,883,1.0,1.0
340,373,1,884,0,490,0.554,0.0,0,762,0.862,0.0,0,822,0.93,0.0,1,873,0.988,1.0,1,883,0.999,1.0,1,884,1.0,1.0,1,884,1.0,1.0
341,374,1,885,1,491,0.555,1.0,1,763,0.862,1.0,1,823,0.93,1.0,1,874,0.988,1.0,1,884,0.999,1.0,1,885,1.0,1.0,1,885,1.0,1.0
342,375,1,886,0,491,0.554,0.0,1,764,0.862,1.0,1,824,0.93,1.0,1,875,0.988,1.0,1,885,0.999,1.0,1,886,1.0,1.0,1,886,1.0,1.0
343,376,1,887,0,491,0.554,0.0,1,765,0.862,1.0,1,825,0.93,1.0,1,876,0.988,1.0,1,886,0.999,1.0,1,887,1.0,1.0,1,887,1.0,1.0
344,380,1,888,0,491,0.553,0.0,0,765,0.861,0.0,1,826,0.93,1.0,1,877,0.988,1.0,1,887,0.999,1.0,1,888,1.0,1.0,1,888,1.0,1.0
345,381,1,889,0,491,0.552,0.0,0,765,0.861,0.0,0,826,0.929,0.0,0,877,0.987,0.0,0,887,0.998,0.0,1,889,1.0,1.0,1,889,1.0,1.0
346,382,2,891,1,492,0.552,0.5,1,766,0.86,0.5,1,827,0.928,0.5,2,879,0.987,1.0,2,889,0.998,1.0,2,891,1.0,1.0,2,891,1.0,1.0
347,383,4,895,2,494,0.552,0.5,3,769,0.859,0.75,3,830,0.927,0.75,4,883,0.987,1.0,4,893,0.998,1.0,4,895,1.0,1.0,4,895,1.0,1.0
348,384,1,896,1,495,0.552,1.0,1,770,0.859,1.0,1,831,0.927,1.0,1,884,0.987,1.0,1,894,0.998,1.0,1,896,1.0,1.0,1,896,1.0,1.0
349,385,3,899,2,497,0.553,0.667,3,773,0.86,1.0,3,834,0.928,1.0,3,887,0.987,1.0,3,897,0.998,1.0,3,899,1.0,1.0,3,899,1.0,1.0
350,386,3,902,1,498,0.552,0.333,3,776,0.86,1.0,3,837,0.928,1.0,3,890,0.987,1.0,3,900,0.998,1.0,3,902,1.0,1.0,3,902,1.0,1.0
351,387,2,904,1,499,0.552,0.5,2,778,0.861,1.0,2,839,0.928,1.0,2,892,0.987,1.0,2,902,0.998,1.0,2,904,1.0,1.0,2,904,1.0,1.0
352,388,2,906,0,499,0.551,0.0,2,780,0.861,1.0,2,841,0.928,1.0,2,894,0.987,1.0,2,904,0.998,1.0,2,906,1.0,1.0,2,906,1.0,1.0
353,389,3,909,1,500,0.55,0.333,2,782,0.86,0.667,2,843,0.927,0.667,3,897,0.987,1.0,3,907,0.998,1.0,3,909,1.0,1.0,3,909,1.0,1.0
354,390,2,911,1,501,0.55,0.5,1,783,0.859,0.5,1,844,0.926,0.5,2,899,0.987,1.0,2,909,0.998,1.0,2,911,1.0,1.0,2,911,1.0,1.0
355,391,2,913,1,502,0.55,0.5,2,785,0.86,1.0,2,846,0.927,1.0,2,901,0.987,1.0,2,911,0.998,1.0,2,913,1.0,1.0,2,913,1.0,1.0
356,392,3,916,0,502,0.548,0.0,1,786,0.858,0.333,1,847,0.925,0.333,2,903,0.986,0.667,3,914,0.998,1.0,3,916,1.0,1.0,3,916,1.0,1.0
357,393,1,917,0,502,0.547,0.0,0,786,0.857,0.0,0,847,0.924,0.0,1,904,0.986,1.0,1,915,0.998,1.0,1,917,1.0,1.0,1,917,1.0,1.0
358,394,4,921,1,503,0.546,0.25,4,790,0.858,1.0,4,851,0.924,1.0,4,908,0.986,1.0,4,919,0.998,1.0,4,921,1.0,1.0,4,921,1.0,1.0
359,395,1,922,1,504,0.547,1.0,1,791,0.858,1.0,1,852,0.924,1.0,1,909,0.986,1.0,1,920,0.998,1.0,1,922,1.0,1.0,1,922,1.0,1.0
360,396,2,924,0,504,0.545,0.0,0,791,0.856,0.0,1,853,0.923,0.5,2,911,0.986,1.0,2,922,0.998,1.0,2,924,1.0,1.0,2,924,1.0,1.0
361,397,2,926,1,505,0.545,0.5,2,793,0.856,1.0,2,855,0.923,1.0,2,913,0.986,1.0,2,924,0.998,1.0,2,926,1.0,1.0,2,926,1.0,1.0
362,398,2,928,0,505,0.544,0.0,2,795,0.857,1.0,2,857,0.923,1.0,2,915,0.986,1.0,2,926,0.998,1.0,2,928,1.0,1.0,2,928,1.0,1.0
363,399,3,931,2,507,0.545,0.667,2,797,0.856,0.667,2,859,0.923,0.667,2,917,0.985,0.667,3,929,0.998,1.0,3,931,1.0,1.0,3,931,1.0,1.0
364,400,3,934,0,507,0.543,0.0,2,799,0.855,0.667,2,861,0.922,0.667,3,920,0.985,1.0,3,932,0.998,1.0,3,934,1.0,1.0,3,934,1.0,1.0
365,401,1,935,0,507,0.542,0.0,1,800,0.856,1.0,1,862,0.922,1.0,1,921,0.985,1.0,1,933,0.998,1.0,1,935,1.0,1.0,1,935,1.0,1.0
366,402,2,937,1,508,0.542,0.5,2,802,0.856,1.0,2,864,0.922,1.0,2,923,0.985,1.0,2,935,0.998,1.0,2,937,1.0,1.0,2,937,1.0,1.0
367,404,1,938,0,508,0.542,0.0,1,803,0.856,1.0,1,865,0.922,1.0,1,924,0.985,1.0,1,936,0.998,1.0,1,938,1.0,1.0,1,938,1.0,1.0
368,405,1,939,0,508,0.541,0.0,1,804,0.856,1.0,1,866,0.922,1.0,1,925,0.985,1.0,1,937,0.998,1.0,1,939,1.0,1.0,1,939,1.0,1.0
369,407,2,941,1,509,0.541,0.5,1,805,0.855,0.5,2,868,0.922,1.0,2,927,0.985,1.0,2,939,0.998,1.0,2,941,1.0,1.0,2,941,1.0,1.0
370,408,1,942,0,509,0.54,0.0,1,806,0.856,1.0,1,869,0.923,1.0,1,928,0.985,1.0,1,940,0.998,1.0,1,942,1.0,1.0,1,942,1.0,1.0
371,409,3,945,2,511,0.541,0.667,3,809,0.856,1.0,3,872,0.923,1.0,3,931,0.985,1.0,3,943,0.998,1.0,3,945,1.0,1.0,3,945,1.0,1.0
372,410,1,946,0,511,0.54,0.0,0,809,0.855,0.0,0,872,0.922,0.0,1,932,0.985,1.0,1,944,0.998,1.0,1,946,1.0,1.0,1,946,1.0,1.0
373,411,2,948,0,511,0.539,0.0,0,809,0.853,0.0,2,874,0.922,1.0,2,934,0.985,1.0,2,946,0.998,1.0,2,948,1.0,1.0,2,948,1.0,1.0
374,412,1,949,1,512,0.54,1.0,1,810,0.854,1.0,1,875,0.922,1.0,1,935,0.985,1.0,1,947,0.998,1.0,1,949,1.0,1.0,1,949,1.0,1.0
375,413,1,950,0,512,0.539,0.0,1,811,0.854,1.0,1,876,0.922,1.0,1,936,0.985,1.0,1,948,0.998,1.0,1,950,1.0,1.0,1,950,1.0,1.0
376,414,2,952,1,513,0.539,0.5,2,813,0.854,1.0,2,878,0.922,1.0,2,938,0.985,1.0,2,950,0.998,1.0,2,952,1.0,1.0,2,952,1.0,1.0
377,415,3,955,0,513,0.537,0.0,3,816,0.854,1.0,3,881,0.923,1.0,3,941,0.985,1.0,3,953,0.998,1.0,3,955,1.0,1.0,3,955,1.0,1.0
378,416,1,956,0,513,0.537,0.0,0,816,0.854,0.0,1,882,0.923,1.0,1,942,0.985,1.0,1,954,0.998,1.0,1,956,1.0,1.0,1,956,1.0,1.0
379,418,1,957,0,513,0.536,0.0,0,816,0.853,0.0,1,883,0.923,1.0,1,943,0.985,1.0,1,955,0.998,1.0,1,957,1.0,1.0,1,957,1.0,1.0
380,419,3,960,0,513,0.534,0.0,1,817,0.851,0.333,2,885,0.922,0.667,3,946,0.985,1.0,3,958,0.998,1.0,3,960,1.0,1.0,3,960,1.0,1.0
381,421,1,961,1,514,0.535,1.0,1,818,0.851,1.0,1,886,0.922,1.0,1,947,0.985,1.0,1,959,0.998,1.0,1,961,1.0,1.0,1,961,1.0,1.0
382,422,4,965,2,516,0.535,0.5,4,822,0.852,1.0,4,890,0.922,1.0,4,951,0.985,1.0,4,963,0.998,1.0,4,965,1.0,1.0,4,965,1.0,1.0
383,423,2,967,1,517,0.535,0.5,1,823,0.851,0.5,2,892,0.922,1.0,2,953,0.986,1.0,2,965,0.998,1.0,2,967,1.0,1.0,2,967,1.0,1.0
384,424,2,969,1,518,0.535,0.5,2,825,0.851,1.0,2,894,0.923,1.0,2,955,0.986,1.0,2,967,0.998,1.0,2,969,1.0,1.0,2,969,1.0,1.0
385,425,1,970,0,518,0.534,0.0,0,825,0.851,0.0,1,895,0.923,1.0,1,956,0.986,1.0,1,968,0.998,1.0,1,970,1.0,1.0,1,970,1.0,1.0
386,427,3,973,1,519,0.533,0.333,3,828,0.851,1.0,3,898,0.923,1.0,3,959,0.986,1.0,3,971,0.998,1.0,3,973,1.0,1.0,3,973,1.0,1.0
387,428,2,975,1,520,0.533,0.5,2,830,0.851,1.0,2,900,0.923,1.0,2,961,0.986,1.0,2,973,0.998,1.0,2,975,1.0,1.0,2,975,1.0,1.0
388,429,3,978,0,520,0.532,0.0,1,831,0.85,0.333,2,902,0.922,0.667,2,963,0.985,0.667,3,976,0.998,1.0,3,978,1.0,1.0,3,978,1.0,1.0
389,430,2,980,1,521,0.532,0.5,2,833,0.85,1.0,2,904,0.922,1.0,2,965,0.985,1.0,2,978,0.998,1.0,2,980,1.0,1.0,2,980,1.0,1.0
390,431,3,983,1,522,0.531,0.333,1,834,0.848,0.333,2,906,0.922,0.667,3,968,0.985,1.0,3,981,0.998,1.0,3,983,1.0,1.0,3,983,1.0,1.0
391,432,3,986,1,523,0.53,0.333,2,836,0.848,0.667,2,908,0.921,0.667,3,971,0.985,1.0,3,984,0.998,1.0,3,986,1.0,1.0,3,986,1.0,1.0
392,433,2,988,2,525,0.531,1.0,2,838,0.848,1.0,2,910,0.921,1.0,2,973,0.985,1.0,2,986,0.998,1.0,2,988,1.0,1.0,2,988,1.0,1.0
393,435,4,992,2,527,0.531,0.5,3,841,0.848,0.75,3,913,0.92,0.75,4,977,0.985,1.0,4,990,0.998,1.0,4,992,1.0,1.0,4,992,1.0,1.0
394,438,4,996,0,527,0.529,0.0,2,843,0.846,0.5,3,916,0.92,0.75,3,980,0.984,0.75,3,993,0.997,0.75,3,995,0.999,0.75,4,996,1.0,1.0
395,439,3,999,0,527,0.528,0.0,2,845,0.846,0.667,3,919,0.92,1.0,3,983,0.984,1.0,3,996,0.997,1.0,3,998,0.999,1.0,3,999,1.0,1.0
396,440,2,1001,1,528,0.527,0.5,1,846,0.845,0.5,1,920,0.919,0.5,1,984,0.983,0.5,1,997,0.996,0.5,2,1000,0.999,1.0,2,1001,1.0,1.0
397,441,1,1002,0,528,0.527,0.0,0,846,0.844,0.0,0,920,0.918,0.0,1,985,0.983,1.0,1,998,0.996,1.0,1,1001,0.999,1.0,1,1002,1.0,1.0
398,442,3,1005,0,528,0.525,0.0,2,848,0.844,0.667,2,922,0.917,0.667,3,988,0.983,1.0,3,1001,0.996,1.0,3,1004,0.999,1.0,3,1005,1.0,1.0
399,444,2,1007,0,528,0.524,0.0,0,848,0.842,0.0,1,923,0.917,0.5,2,990,0.983,1.0,2,1003,0.996,1.0,2,1006,0.999,1.0,2,1007,1.0,1.0
400,446,4,1011,1,529,0.523,0.25,3,851,0.842,0.75,4,927,0.917,1.0,4,994,0.983,1.0,4,1007,0.996,1.0,4,1010,0.999,1.0,4,1011,1.0,1.0
401,447,1,1012,0,529,0.523,0.0,1,852,0.842,1.0,1,928,0.917,1.0,1,995,0.983,1.0,1,1008,0.996,1.0,1,1011,0.999,1.0,1,1012,1.0,1.0
402,448,2,1014,0,529,0.522,0.0,0,852,0.84,0.0,2,930,0.917,1.0,2,997,0.983,1.0,2,1010,0.996,1.0,2,1013,0.999,1.0,2,1014,1.0,1.0
403,449,1,1015,0,529,0.521,0.0,0,852,0.839,0.0,1,931,0.917,1.0,1,998,0.983,1.0,1,1011,0.996,1.0,1,1014,0.999,1.0,1,1015,1.0,1.0
404,450,3,1018,0,529,0.52,0.0,2,854,0.839,0.667,2,933,0.917,0.667,3,1001,0.983,1.0,3,1014,0.996,1.0,3,1017,0.999,1.0,3,1018,1.0,1.0
405,452,3,1021,1,530,0.519,0.333,2,856,0.838,0.667,2,935,0.916,0.667,3,1004,0.983,1.0,3,1017,0.996,1.0,3,1020,0.999,1.0,3,1021,1.0,1.0
406,453,1,1022,1,531,0.52,1.0,1,857,0.839,1.0,1,936,0.916,1.0,1,1005,0.983,1.0,1,1018,0.996,1.0,1,1021,0.999,1.0,1,1022,1.0,1.0
407,454,2,1024,0,531,0.519,0.0,0,857,0.837,0.0,1,937,0.915,0.5,2,1007,0.983,1.0,2,1020,0.996,1.0,2,1023,0.999,1.0,2,1024,1.0,1.0
408,455,2,1026,1,532,0.519,0.5,1,858,0.836,0.5,1,938,0.914,0.5,2,1009,0.983,1.0,2,1022,0.996,1.0,2,1025,0.999,1.0,2,1026,1.0,1.0
409,456,2,1028,0,532,0.518,0.0,2,860,0.837,1.0,2,940,0.914,1.0,2,1011,0.983,1.0,2,1024,0.996,1.0,2,1027,0.999,1.0,2,1028,1.0,1.0
410,457,1,1029,0,532,0.517,0.0,1,861,0.837,1.0,1,941,0.914,1.0,1,1012,0.983,1.0,1,1025,0.996,1.0,1,1028,0.999,1.0,1,1029,1.0,1.0
411,458,1,1030,1,533,0.517,1.0,1,862,0.837,1.0,1,942,0.915,1.0,1,1013,0.983,1.0,1,1026,0.996,1.0,1,1029,0.999,1.0,1,1030,1.0,1.0
412,460,2,1032,0,533,0.516,0.0,0,862,0.835,0.0,0,942,0.913,0.0,1,1014,0.983,0.5,2,1028,0.996,1.0,2,1031,0.999,1.0,2,1032,1.0,1.0
413,461,2,1034,1,534,0.516,0.5,1,863,0.835,0.5,1,943,0.912,0.5,1,1015,0.982,0.5,2,1030,0.996,1.0,2,1033,0.999,1.0,2,1034,1.0,1.0
414,462,1,1035,0,534,0.516,0.0,1,864,0.835,1.0,1,944,0.912,1.0,1,1016,0.982,1.0,1,1031,0.996,1.0,1,1034,0.999,1.0,1,1035,1.0,1.0
415,464,1,1036,0,534,0.515,0.0,0,864,0.834,0.0,0,944,0.911,0.0,1,1017,0.982,1.0,1,1032,0.996,1.0,1,1035,0.999,1.0,1,1036,1.0,1.0
416,465,1,1037,0,534,0.515,0.0,0,864,0.833,0.0,0,944,0.91,0.0,1,1018,0.982,1.0,1,1033,0.996,1.0,1,1036,0.999,1.0,1,1037,1.0,1.0
417,468,1,1038,1,535,0.515,1.0,1,865,0.833,1.0,1,945,0.91,1.0,1,1019,0.982,1.0,1,1034,0.996,1.0,1,1037,0.999,1.0,1,1038,1.0,1.0
418,469,1,1039,0,535,0.515,0.0,0,865,0.833,0.0,0,945,0.91,0.0,1,1020,0.982,1.0,1,1035,0.996,1.0,1,1038,0.999,1.0,1,1039,1.0,1.0
419,470,3,1042,1,536,0.514,0.333,3,868,0.833,1.0,3,948,0.91,1.0,3,1023,0.982,1.0,3,1038,0.996,1.0,3,1041,0.999,1.0,3,1042,1.0,1.0
420,471,1,1043,0,536,0.514,0.0,0,868,0.832,0.0,0,948,0.909,0.0,1,1024,0.982,1.0,1,1039,0.996,1.0,1,1042,0.999,1.0,1,1043,1.0,1.0
421,472,1,1044,0,536,0.513,0.0,1,869,0.832,1.0,1,949,0.909,1.0,1,1025,0.982,1.0,1,1040,0.996,1.0,1,1043,0.999,1.0,1,1044,1.0,1.0
422,473,1,1045,0,536,0.513,0.0,1,870,0.833,1.0,1,950,0.909,1.0,1,1026,0.982,1.0,1,1041,0.996,1.0,1,1044,0.999,1.0,1,1045,1.0,1.0
423,475,2,1047,0,536,0.512,0.0,1,871,0.832,0.5,1,951,0.908,0.5,2,1028,0.982,1.0,2,1043,0.996,1.0,2,1046,0.999,1.0,2,1047,1.0,1.0
424,476,1,1048,1,537,0.512,1.0,1,872,0.832,1.0,1,952,0.908,1.0,1,1029,0.982,1.0,1,1044,0.996,1.0,1,1047,0.999,1.0,1,1048,1.0,1.0
425,477,2,1050,0,537,0.511,0.0,0,872,0.83,0.0,1,953,0.908,0.5,2,1031,0.982,1.0,2,1046,0.996,1.0,2,1049,0.999,1.0,2,1050,1.0,1.0
426,478,1,1051,0,537,0.511,0.0,0,872,0.83,0.0,0,953,0.907,0.0,0,1031,0.981,0.0,1,1047,0.996,1.0,1,1050,0.999,1.0,1,1051,1.0,1.0
427,479,1,1052,1,538,0.511,1.0,1,873,0.83,1.0,1,954,0.907,1.0,1,1032,0.981,1.0,1,1048,0.996,1.0,1,1051,0.999,1.0,1,1052,1.0,1.0
428,480,3,1055,0,538,0.51,0.0,2,875,0.829,0.667,2,956,0.906,0.667,3,1035,0.981,1.0,3,1051,0.996,1.0,3,1054,0.999,1.0,3,1055,1.0,1.0
429,482,2,1057,1,539,0.51,0.5,2,877,0.83,1.0,2,958,0.906,1.0,2,1037,0.981,1.0,2,1053,0.996,1.0,2,1056,0.999,1.0,2,1057,1.0,1.0
430,484,4,1061,2,541,0.51,0.5,3,880,0.829,0.75,4,962,0.907,1.0,4,1041,0.981,1.0,4,1057,0.996,1.0,4,1060,0.999,1.0,4,1061,1.0,1.0
431,485,1,1062,1,542,0.51,1.0,1,881,0.83,1.0,1,963,0.907,1.0,1,1042,0.981,1.0,1,1058,0.996,1.0,1,1061,0.999,1.0,1,1062,1.0,1.0
432,486,1,1063,0,542,0.51,0.0,0,881,0.829,0.0,1,964,0.907,1.0,1,1043,0.981,1.0,1,1059,0.996,1.0,1,1062,0.999,1.0,1,1063,1.0,1.0
433,487,2,1065,0,542,0.509,0.0,2,883,0.829,1.0,2,966,0.907,1.0,2,1045,0.981,1.0,2,1061,0.996,1.0,2,1064,0.999,1.0,2,1065,1.0,1.0
434,489,1,1066,0,542,0.508,0.0,0,883,0.828,0.0,0,966,0.906,0.0,1,1046,0.981,1.0,1,1062,0.996,1.0,1,1065,0.999,1.0,1,1066,1.0,1.0
435,490,1,1067,1,543,0.509,1.0,1,884,0.828,1.0,1,967,0.906,1.0,1,1047,0.981,1.0,1,1063,0.996,1.0,1,1066,0.999,1.0,1,1067,1.0,1.0
436,491,2,1069,0,543,0.508,0.0,0,884,0.827,0.0,0,967,0.905,0.0,2,1049,0.981,1.0,2,1065,0.996,1.0,2,1068,0.999,1.0,2,1069,1.0,1.0
437,492,2,1071,0,543,0.507,0.0,1,885,0.826,0.5,2,969,0.905,1.0,2,1051,0.981,1.0,2,1067,0.996,1.0,2,1070,0.999,1.0,2,1071,1.0,1.0
438,494,2,1073,2,545,0.508,1.0,2,887,0.827,1.0,2,971,0.905,1.0,2,1053,0.981,1.0,2,1069,0.996,1.0,2,1072,0.999,1.0,2,1073,1.0,1.0
439,498,1,1074,0,545,0.507,0.0,1,888,0.827,1.0,1,972,0.905,1.0,1,1054,0.981,1.0,1,1070,0.996,1.0,1,1073,0.999,1.0,1,1074,1.0,1.0
440,500,1,1075,0,545,0.507,0.0,1,889,0.827,1.0,1,973,0.905,1.0,1,1055,0.981,1.0,1,1071,0.996,1.0,1,1074,0.999,1.0,1,1075,1.0,1.0
441,501,1,1076,0,545,0.507,0.0,0,889,0.826,0.0,1,974,0.905,1.0,1,1056,0.981,1.0,1,1072,0.996,1.0,1,1075,0.999,1.0,1,1076,1.0,1.0
442,502,1,1077,0,545,0.506,0.0,0,889,0.825,0.0,0,974,0.904,0.0,1,1057,0.981,1.0,1,1073,0.996,1.0,1,1076,0.999,1.0,1,1077,1.0,1.0
443,503,2,1079,0,545,0.505,0.0,1,890,0.825,0.5,2,976,0.905,1.0,2,1059,0.981,1.0,2,1075,0.996,1.0,2,1078,0.999,1.0,2,1079,1.0,1.0
444,504,3,1082,1,546,0.505,0.333,1,891,0.823,0.333,1,977,0.903,0.333,2,1061,0.981,0.667,3,1078,0.996,1.0,3,1081,0.999,1.0,3,1082,1.0,1.0
445,505,1,1083,0,546,0.504,0.0,1,892,0.824,1.0,1,978,0.903,1.0,1,1062,0.981,1.0,1,1079,0.996,1.0,1,1082,0.999,1.0,1,1083,1.0,1.0
446,506,1,1084,1,547,0.505,1.0,1,893,0.824,1.0,1,979,0.903,1.0,1,1063,0.981,1.0,1,1080,0.996,1.0,1,1083,0.999,1.0,1,1084,1.0,1.0
447,507,2,1086,0,547,0.504,0.0,2,895,0.824,1.0,2,981,0.903,1.0,2,1065,0.981,1.0,2,1082,0.996,1.0,2,1085,0.999,1.0,2,1086,1.0,1.0
448,508,3,1089,0,547,0.502,0.0,2,897,0.824,0.667,2,983,0.903,0.667,3,1068,0.981,1.0,3,1085,0.996,1.0,3,1088,0.999,1.0,3,1089,1.0,1.0
449,511,3,1092,1,548,0.502,0.333,2,899,0.823,0.667,2,985,0.902,0.667,2,1070,0.98,0.667,3,1088,0.996,1.0,3,1091,0.999,1.0,3,1092,1.0,1.0
450,512,4,1096,0,548,0.5,0.0,2,901,0.822,0.5,3,988,0.901,0.75,4,1074,0.98,1.0,4,1092,0.996,1.0,4,1095,0.999,1.0,4,1096,1.0,1.0
451,514,1,1097,0,548,0.5,0.0,1,902,0.822,1.0,1,989,0.902,1.0,1,1075,0.98,1.0,1,1093,0.996,1.0,1,1096,0.999,1.0,1,1097,1.0,1.0
452,515,3,1100,0,548,0.498,0.0,0,902,0.82,0.0,0,989,0.899,0.0,3,1078,0.98,1.0,3,1096,0.996,1.0,3,1099,0.999,1.0,3,1100,1.0,1.0
453,517,2,1102,0,548,0.497,0.0,1,903,0.819,0.5,1,990,0.898,0.5,2,1080,0.98,1.0,2,1098,0.996,1.0,2,1101,0.999,1.0,2,1102,1.0,1.0
454,518,3,1105,1,549,0.497,0.333,2,905,0.819,0.667,2,992,0.898,0.667,3,1083,0.98,1.0,3,1101,0.996,1.0,3,1104,0.999,1.0,3,1105,1.0,1.0
455,519,4,1109,1,550,0.496,0.25,3,908,0.819,0.75,3,995,0.897,0.75,4,1087,0.98,1.0,4,1105,0.996,1.0,4,1108,0.999,1.0,4,1109,1.0,1.0
456,520,2,1111,1,551,0.496,0.5,1,909,0.818,0.5,2,997,0.897,1.0,2,1089,0.98,1.0,2,1107,0.996,1.0,2,1110,0.999,1.0,2,1111,1.0,1.0
457,521,1,1112,0,551,0.496,0.0,1,910,0.818,1.0,1,998,0.897,1.0,1,1090,0.98,1.0,1,1108,0.996,1.0,1,1111,0.999,1.0,1,1112,1.0,1.0
458,522,1,1113,0,551,0.495,0.0,1,911,0.819,1.0,1,999,0.898,1.0,1,1091,0.98,1.0,1,1109,0.996,1.0,1,1112,0.999,1.0,1,1113,1.0,1.0
459,524,2,1115,1,552,0.495,0.5,1,912,0.818,0.5,1,1000,0.897,0.5,2,1093,0.98,1.0,2,1111,0.996,1.0,2,1114,0.999,1.0,2,1115,1.0,1.0
460,525,4,1119,1,553,0.494,0.25,2,914,0.817,0.5,2,1002,0.895,0.5,4,1097,0.98,1.0,4,1115,0.996,1.0,4,1118,0.999,1.0,4,1119,1.0,1.0
461,527,1,1120,0,553,0.494,0.0,1,915,0.817,1.0,1,1003,0.896,1.0,1,1098,0.98,1.0,1,1116,0.996,1.0,1,1119,0.999,1.0,1,1120,1.0,1.0
462,528,1,1121,0,553,0.493,0.0,1,916,0.817,1.0,1,1004,0.896,1.0,1,1099,0.98,1.0,1,1117,0.996,1.0,1,1120,0.999,1.0,1,1121,1.0,1.0
463,530,2,1123,1,554,0.493,0.5,1,917,0.817,0.5,1,1005,0.895,0.5,1,1100,0.98,0.5,1,1118,0.996,0.5,2,1122,0.999,1.0,2,1123,1.0,1.0
464,531,2,1125,0,554,0.492,0.0,1,918,0.816,0.5,2,1007,0.895,1.0,2,1102,0.98,1.0,2,1120,0.996,1.0,2,1124,0.999,1.0,2,1125,1.0,1.0
465,532,2,1127,0,554,0.492,0.0,1,919,0.815,0.5,1,1008,0.894,0.5,2,1104,0.98,1.0,2,1122,0.996,1.0,2,1126,0.999,1.0,2,1127,1.0,1.0
466,533,2,1129,0,554,0.491,0.0,1,920,0.815,0.5,2,1010,0.895,1.0,2,1106,0.98,1.0,2,1124,0.996,1.0,2,1128,0.999,1.0,2,1129,1.0,1.0
467,534,3,1132,0,554,0.489,0.0,1,921,0.814,0.333,3,1013,0.895,1.0,3,1109,0.98,1.0,3,1127,0.996,1.0,3,1131,0.999,1.0,3,1132,1.0,1.0
468,536,2,1134,1,555,0.489,0.5,1,922,0.813,0.5,1,1014,0.894,0.5,2,1111,0.98,1.0,2,1129,0.996,1.0,2,1133,0.999,1.0,2,1134,1.0,1.0
469,537,2,1136,0,555,0.489,0.0,0,922,0.812,0.0,1,1015,0.893,0.5,2,1113,0.98,1.0,2,1131,0.996,1.0,2,1135,0.999,1.0,2,1136,1.0,1.0
470,538,1,1137,0,555,0.488,0.0,0,922,0.811,0.0,1,1016,0.894,1.0,1,1114,0.98,1.0,1,1132,0.996,1.0,1,1136,0.999,1.0,1,1137,1.0,1.0
471,539,2,1139,0,555,0.487,0.0,1,923,0.81,0.5,2,1018,0.894,1.0,2,1116,0.98,1.0,2,1134,0.996,1.0,2,1138,0.999,1.0,2,1139,1.0,1.0
472,540,1,1140,0,555,0.487,0.0,0,923,0.81,0.0,0,1018,0.893,0.0,1,1117,0.98,1.0,1,1135,0.996,1.0,1,1139,0.999,1.0,1,1140,1.0,1.0
473,542,3,1143,1,556,0.486,0.333,3,926,0.81,1.0,3,1021,0.893,1.0,3,1120,0.98,1.0,3,1138,0.996,1.0,3,1142,0.999,1.0,3,1143,1.0,1.0
474,543,3,1146,0,556,0.485,0.0,0,926,0.808,0.0,1,1022,0.892,0.333,2,1122,0.979,0.667,2,1140,0.995,0.667,2,1144,0.998,0.667,3,1146,1.0,1.0
475,545,2,1148,0,556,0.484,0.0,1,927,0.807,0.5,1,1023,0.891,0.5,2,1124,0.979,1.0,2,1142,0.995,1.0,2,1146,0.998,1.0,2,1148,1.0,1.0
476,546,1,1149,0,556,0.484,0.0,0,927,0.807,0.0,0,1023,0.89,0.0,1,1125,0.979,1.0,1,1143,0.995,1.0,1,1147,0.998,1.0,1,1149,1.0,1.0
477,547,2,1151,0,556,0.483,0.0,0,927,0.805,0.0,1,1024,0.89,0.5,2,1127,0.979,1.0,2,1145,0.995,1.0,2,1149,0.998,1.0,2,1151,1.0,1.0
478,548,1,1152,0,556,0.483,0.0,0,927,0.805,0.0,1,1025,0.89,1.0,1,1128,0.979,1.0,1,1146,0.995,1.0,1,1150,0.998,1.0,1,1152,1.0,1.0
479,549,1,1153,1,557,0.483,1.0,1,928,0.805,1.0,1,1026,0.89,1.0,1,1129,0.979,1.0,1,1147,0.995,1.0,1,1151,0.998,1.0,1,1153,1.0,1.0
480,551,1,1154,1,558,0.484,1.0,1,929,0.805,1.0,1,1027,0.89,1.0,1,1130,0.979,1.0,1,1148,0.995,1.0,1,1152,0.998,1.0,1,1154,1.0,1.0
481,554,1,1155,1,559,0.484,1.0,1,930,0.805,1.0,1,1028,0.89,1.0,1,1131,0.979,1.0,1,1149,0.995,1.0,1,1153,0.998,1.0,1,1155,1.0,1.0
482,555,2,1157,0,559,0.483,0.0,1,931,0.805,0.5,1,1029,0.889,0.5,2,1133,0.979,1.0,2,1151,0.995,1.0,2,1155,0.998,1.0,2,1157,1.0,1.0
483,556,4,1161,0,559,0.481,0.0,1,932,0.803,0.25,2,1031,0.888,0.5,3,1136,0.978,0.75,4,1155,0.995,1.0,4,1159,0.998,1.0,4,1161,1.0,1.0
484,558,1,1162,1,560,0.482,1.0,1,933,0.803,1.0,1,1032,0.888,1.0,1,1137,0.978,1.0,1,1156,0.995,1.0,1,1160,0.998,1.0,1,1162,1.0,1.0
485,559,2,1164,0,560,0.481,0.0,1,934,0.802,0.5,1,1033,0.887,0.5,2,1139,0.979,1.0,2,1158,0.995,1.0,2,1162,0.998,1.0,2,1164,1.0,1.0
486,561,1,1165,0,560,0.481,0.0,0,934,0.802,0.0,1,1034,0.888,1.0,1,1140,0.979,1.0,1,1159,0.995,1.0,1,1163,0.998,1.0,1,1165,1.0,1.0
487,562,2,1167,0,560,0.48,0.0,1,935,0.801,0.5,1,1035,0.887,0.5,2,1142,0.979,1.0,2,1161,0.995,1.0,2,1165,0.998,1.0,2,1167,1.0,1.0
488,564,1,1168,1,561,0.48,1.0,1,936,0.801,1.0,1,1036,0.887,1.0,1,1143,0.979,1.0,1,1162,0.995,1.0,1,1166,0.998,1.0,1,1168,1.0,1.0
489,565,3,1171,0,561,0.479,0.0,3,939,0.802,1.0,3,1039,0.887,1.0,3,1146,0.979,1.0,3,1165,0.995,1.0,3,1169,0.998,1.0,3,1171,1.0,1.0
490,566,1,1172,0,561,0.479,0.0,1,940,0.802,1.0,1,1040,0.887,1.0,1,1147,0.979,1.0,1,1166,0.995,1.0,1,1170,0.998,1.0,1,1172,1.0,1.0
491,567,3,1175,0,561,0.477,0.0,2,942,0.802,0.667,2,1042,0.887,0.667,3,1150,0.979,1.0,3,1169,0.995,1.0,3,1173,0.998,1.0,3,1175,1.0,1.0
492,570,1,1176,0,561,0.477,0.0,0,942,0.801,0.0,0,1042,0.886,0.0,1,1151,0.979,1.0,1,1170,0.995,1.0,1,1174,0.998,1.0,1,1176,1.0,1.0
493,573,1,1177,0,561,0.477,0.0,0,942,0.8,0.0,1,1043,0.886,1.0,1,1152,0.979,1.0,1,1171,0.995,1.0,1,1175,0.998,1.0,1,1177,1.0,1.0
494,581,1,1178,1,562,0.477,1.0,1,943,0.801,1.0,1,1044,0.886,1.0,1,1153,0.979,1.0,1,1172,0.995,1.0,1,1176,0.998,1.0,1,1178,1.0,1.0
495,585,2,1180,0,562,0.476,0.0,1,944,0.8,0.5,2,1046,0.886,1.0,2,1155,0.979,1.0,2,1174,0.995,1.0,2,1178,0.998,1.0,2,1180,1.0,1.0
496,587,4,1184,1,563,0.476,0.25,2,946,0.799,0.5,2,1048,0.885,0.5,3,1158,0.978,0.75,4,1178,0.995,1.0,4,1182,0.998,1.0,4,1184,1.0,1.0
497,589,1,1185,0,563,0.475,0.0,0,946,0.798,0.0,1,1049,0.885,1.0,1,1159,0.978,1.0,1,1179,0.995,1.0,1,1183,0.998,1.0,1,1185,1.0,1.0
498,591,1,1186,0,563,0.475,0.0,0,946,0.798,0.0,0,1049,0.884,0.0,1,1160,0.978,1.0,1,1180,0.995,1.0,1,1184,0.998,1.0,1,1186,1.0,1.0
499,592,2,1188,0,563,0.474,0.0,1,947,0.797,0.5,1,1050,0.884,0.5,1,1161,0.977,0.5,2,1182,0.995,1.0,2,1186,0.998,1.0,2,1188,1.0,1.0
500,594,1,1189,0,563,0.474,0.0,1,948,0.797,1.0,1,1051,0.884,1.0,1,1162,0.977,1.0,1,1183,0.995,1.0,1,1187,0.998,1.0,1,1189,1.0,1.0
501,595,3,1192,0,563,0.472,0.0,1,949,0.796,0.333,2,1053,0.883,0.667,3,1165,0.977,1.0,3,1186,0.995,1.0,3,1190,0.998,1.0,3,1192,1.0,1.0
502,596,3,1195,1,564,0.472,0.333,2,951,0.796,0.667,3,1056,0.884,1.0,3,1168,0.977,1.0,3,1189,0.995,1.0,3,1193,0.998,1.0,3,1195,1.0,1.0
503,598,4,1199,1,565,0.471,0.25,2,953,0.795,0.5,3,1059,0.883,0.75,3,1171,0.977,0.75,3,1192,0.994,0.75,3,1196,0.997,0.75,3,1198,0.999,0.75
504,599,1,1200,0,565,0.471,0.0,0,953,0.794,0.0,0,1059,0.882,0.0,1,1172,0.977,1.0,1,1193,0.994,1.0,1,1197,0.998,1.0,1,1199,0.999,1.0
505,600,1,1201,0,565,0.47,0.0,0,953,0.794,0.0,1,1060,0.883,1.0,1,1173,0.977,1.0,1,1194,0.994,1.0,1,1198,0.998,1.0,1,1200,0.999,1.0
506,602,1,1202,0,565,0.47,0.0,1,954,0.794,1.0,1,1061,0.883,1.0,1,1174,0.977,1.0,1,1195,0.994,1.0,1,1199,0.998,1.0,1,1201,0.999,1.0
507,603,2,1204,0,565,0.469,0.0,1,955,0.793,0.5,1,1062,0.882,0.5,1,1175,0.976,0.5,2,1197,0.994,1.0,2,1201,0.998,1.0,2,1203,0.999,1.0
508,604,2,1206,0,565,0.468,0.0,0,955,0.792,0.0,0,1062,0.881,0.0,2,1177,0.976,1.0,2,1199,0.994,1.0,2,1203,0.998,1.0,2,1205,0.999,1.0
509,605,2,1208,0,565,0.468,0.0,1,956,0.791,0.5,1,1063,0.88,0.5,2,1179,0.976,1.0,2,1201,0.994,1.0,2,1205,0.998,1.0,2,1207,0.999,1.0
510,608,1,1209,1,566,0.468,1.0,1,957,0.792,1.0,1,1064,0.88,1.0,1,1180,0.976,1.0,1,1202,0.994,1.0,1,1206,0.998,1.0,1,1208,0.999,1.0
511,609,1,1210,0,566,0.468,0.0,0,957,0.791,0.0,0,1064,0.879,0.0,1,1181,0.976,1.0,1,1203,0.994,1.0,1,1207,0.998,1.0,1,1209,0.999,1.0
512,610,1,1211,0,566,0.467,0.0,0,957,0.79,0.0,1,1065,0.879,1.0,1,1182,0.976,1.0,1,1204,0.994,1.0,1,1208,0.998,1.0,1,1210,0.999,1.0
513,611,2,1213,1,567,0.467,0.5,2,959,0.791,1.0,2,1067,0.88,1.0,2,1184,0.976,1.0,2,1206,0.994,1.0,2,1210,0.998,1.0,2,1212,0.999,1.0
514,612,1,1214,0,567,0.467,0.0,1,960,0.791,1.0,1,1068,0.88,1.0,1,1185,0.976,1.0,1,1207,0.994,1.0,1,1211,0.998,1.0,1,1213,0.999,1.0
515,613,1,1215,1,568,0.467,1.0,1,961,0.791,1.0,1,1069,0.88,1.0,1,1186,0.976,1.0,1,1208,0.994,1.0,1,1212,0.998,1.0,1,1214,0.999,1.0
516,614,2,1217,0,568,0.467,0.0,1,962,0.79,0.5,1,1070,0.879,0.5,2,1188,0.976,1.0,2,1210,0.994,1.0,2,1214,0.998,1.0,2,1216,0.999,1.0
517,615,1,1218,0,568,0.466,0.0,0,962,0.79,0.0,0,1070,0.878,0.0,1,1189,0.976,1.0,1,1211,0.994,1.0,1,1215,0.998,1.0,1,1217,0.999,1.0
518,616,1,1219,0,568,0.466,0.0,0,962,0.789,0.0,1,1071,0.879,1.0,1,1190,0.976,1.0,1,1212,0.994,1.0,1,1216,0.998,1.0,1,1218,0.999,1.0
519,619,5,1224,2,570,0.466,0.4,3,965,0.788,0.6,4,1075,0.878,0.8,4,1194,0.975,0.8,5,1217,0.994,1.0,5,1221,0.998,1.0,5,1223,0.999,1.0
520,622,2,1226,2,572,0.467,1.0,2,967,0.789,1.0,2,1077,0.878,1.0,2,1196,0.976,1.0,2,1219,0.994,1.0,2,1223,0.998,1.0,2,1225,0.999,1.0
521,623,1,1227,0,572,0.466,0.0,0,967,0.788,0.0,0,1077,0.878,0.0,1,1197,0.976,1.0,1,1220,0.994,1.0,1,1224,0.998,1.0,1,1226,0.999,1.0
522,624,1,1228,0,572,0.466,0.0,0,967,0.787,0.0,1,1078,0.878,1.0,1,1198,0.976,1.0,1,1221,0.994,1.0,1,1225,0.998,1.0,1,1227,0.999,1.0
523,625,3,1231,1,573,0.465,0.333,2,969,0.787,0.667,2,1080,0.877,0.667,3,1201,0.976,1.0,3,1224,0.994,1.0,3,1228,0.998,1.0,3,1230,0.999,1.0
524,630,1,1232,0,573,0.465,0.0,1,970,0.787,1.0,1,1081,0.877,1.0,1,1202,0.976,1.0,1,1225,0.994,1.0,1,1229,0.998,1.0,1,1231,0.999,1.0
525,631,1,1233,0,573,0.465,0.0,0,970,0.787,0.0,0,1081,0.877,0.0,1,1203,0.976,1.0,1,1226,0.994,1.0,1,1230,0.998,1.0,1,1232,0.999,1.0
526,632,3,1236,0,573,0.464,0.0,3,973,0.787,1.0,3,1084,0.877,1.0,3,1206,0.976,1.0,3,1229,0.994,1.0,3,1233,0.998,1.0,3,1235,0.999,1.0
527,633,2,1238,0,573,0.463,0.0,1,974,0.787,0.5,2,1086,0.877,1.0,2,1208,0.976,1.0,2,1231,0.994,1.0,2,1235,0.998,1.0,2,1237,0.999,1.0
528,634,2,1240,1,574,0.463,0.5,1,975,0.786,0.5,1,1087,0.877,0.5,2,1210,0.976,1.0,2,1233,0.994,1.0,2,1237,0.998,1.0,2,1239,0.999,1.0
529,635,1,1241,0,574,0.463,0.0,0,975,0.786,0.0,0,1087,0.876,0.0,0,1210,0.975,0.0,1,1234,0.994,1.0,1,1238,0.998,1.0,1,1240,0.999,1.0
530,639,1,1242,0,574,0.462,0.0,0,975,0.785,0.0,1,1088,0.876,1.0,1,1211,0.975,1.0,1,1235,0.994,1.0,1,1239,0.998,1.0,1,1241,0.999,1.0
531,640,1,1243,0,574,0.462,0.0,1,976,0.785,1.0,1,1089,0.876,1.0,1,1212,0.975,1.0,1,1236,0.994,1.0,1,1240,0.998,1.0,1,1242,0.999,1.0
532,641,4,1247,0,574,0.46,0.0,2,978,0.784,0.5,2,1091,0.875,0.5,4,1216,0.975,1.0,4,1240,0.994,1.0,4,1244,0.998,1.0,4,1246,0.999,1.0
533,643,1,1248,0,574,0.46,0.0,0,978,0.784,0.0,0,1091,0.874,0.0,1,1217,0.975,1.0,1,1241,0.994,1.0,1,1245,0.998,1.0,1,1247,0.999,1.0
534,644,1,1249,0,574,0.46,0.0,0,978,0.783,0.0,0,1091,0.873,0.0,1,1218,0.975,1.0,1,1242,0.994,1.0,1,1246,0.998,1.0,1,1248,0.999,1.0
535,645,1,1250,0,574,0.459,0.0,1,979,0.783,1.0,1,1092,0.874,1.0,1,1219,0.975,1.0,1,1243,0.994,1.0,1,1247,0.998,1.0,1,1249,0.999,1.0
536,647,1,1251,0,574,0.459,0.0,0,979,0.783,0.0,1,1093,0.874,1.0,1,1220,0.975,1.0,1,1244,0.994,1.0,1,1248,0.998,1.0,1,1250,0.999,1.0
537,648,1,1252,0,574,0.458,0.0,1,980,0.783,1.0,1,1094,0.874,1.0,1,1221,0.975,1.0,1,1245,0.994,1.0,1,1249,0.998,1.0,1,1251,0.999,1.0
538,649,2,1254,0,574,0.458,0.0,0,980,0.781,0.0,0,1094,0.872,0.0,0,1221,0.974,0.0,1,1246,0.994,0.5,1,1250,0.997,0.5,2,1253,0.999,1.0
539,650,1,1255,0,574,0.457,0.0,0,980,0.781,0.0,0,1094,0.872,0.0,0,1221,0.973,0.0,1,1247,0.994,1.0,1,1251,0.997,1.0,1,1254,0.999,1.0
540,652,2,1257,1,575,0.457,0.5,1,981,0.78,0.5,2,1096,0.872,1.0,2,1223,0.973,1.0,2,1249,0.994,1.0,2,1253,0.997,1.0,2,1256,0.999,1.0
541,655,2,1259,0,575,0.457,0.0,1,982,0.78,0.5,2,1098,0.872,1.0,2,1225,0.973,1.0,2,1251,0.994,1.0,2,1255,0.997,1.0,2,1258,0.999,1.0
542,656,2,1261,0,575,0.456,0.0,0,982,0.779,0.0,0,1098,0.871,0.0,2,1227,0.973,1.0,2,1253,0.994,1.0,2,1257,0.997,1.0,2,1260,0.999,1.0
543,658,1,1262,0,575,0.456,0.0,0,982,0.778,0.0,1,1099,0.871,1.0,1,1228,0.973,1.0,1,1254,0.994,1.0,1,1258,0.997,1.0,1,1261,0.999,1.0
544,660,1,1263,1,576,0.456,1.0,1,983,0.778,1.0,1,1100,0.871,1.0,1,1229,0.973,1.0,1,1255,0.994,1.0,1,1259,0.997,1.0,1,1262,0.999,1.0
545,661,1,1264,0,576,0.456,0.0,0,983,0.778,0.0,0,1100,0.87,0.0,0,1229,0.972,0.0,1,1256,0.994,1.0,1,1260,0.997,1.0,1,1263,0.999,1.0
546,662,1,1265,1,577,0.456,1.0,1,984,0.778,1.0,1,1101,0.87,1.0,1,1230,0.972,1.0,1,1257,0.994,1.0,1,1261,0.997,1.0,1,1264,0.999,1.0
547,664,2,1267,0,577,0.455,0.0,2,986,0.778,1.0,2,1103,0.871,1.0,2,1232,0.972,1.0,2,1259,0.994,1.0,2,1263,0.997,1.0,2,1266,0.999,1.0
548,665,1,1268,0,577,0.455,0.0,0,986,0.778,0.0,1,1104,0.871,1.0,1,1233,0.972,1.0,1,1260,0.994,1.0,1,1264,0.997,1.0,1,1267,0.999,1.0
549,666,1,1269,0,577,0.455,0.0,1,987,0.778,1.0,1,1105,0.871,1.0,1,1234,0.972,1.0,1,1261,0.994,1.0,1,1265,0.997,1.0,1,1268,0.999,1.0
550,667,2,1271,0,577,0.454,0.0,0,987,0.777,0.0,1,1106,0.87,0.5,2,1236,0.972,1.0,2,1263,0.994,1.0,2,1267,0.997,1.0,2,1270,0.999,1.0
551,672,2,1273,1,578,0.454,0.5,2,989,0.777,1.0,2,1108,0.87,1.0,2,1238,0.973,1.0,2,1265,0.994,1.0,2,1269,0.997,1.0,2,1272,0.999,1.0
552,674,1,1274,0,578,0.454,0.0,1,990,0.777,1.0,1,1109,0.87,1.0,1,1239,0.973,1.0,1,1266,0.994,1.0,1,1270,0.997,1.0,1,1273,0.999,1.0
553,675,2,1276,0,578,0.453,0.0,2,992,0.777,1.0,2,1111,0.871,1.0,2,1241,0.973,1.0,2,1268,0.994,1.0,2,1272,0.997,1.0,2,1275,0.999,1.0
554,676,4,1280,0,578,0.452,0.0,1,993,0.776,0.25,2,1113,0.87,0.5,3,1244,0.972,0.75,4,1272,0.994,1.0,4,1276,0.997,1.0,4,1279,0.999,1.0
555,678,2,1282,0,578,0.451,0.0,1,994,0.775,0.5,2,1115,0.87,1.0,2,1246,0.972,1.0,2,1274,0.994,1.0,2,1278,0.997,1.0,2,1281,0.999,1.0
556,679,2,1284,1,579,0.451,0.5,2,996,0.776,1.0,2,1117,0.87,1.0,2,1248,0.972,1.0,2,1276,0.994,1.0,2,1280,0.997,1.0,2,1283,0.999,1.0
557,683,2,1286,0,579,0.45,0.0,1,997,0.775,0.5,2,1119,0.87,1.0,2,1250,0.972,1.0,2,1278,0.994,1.0,2,1282,0.997,1.0,2,1285,0.999,1.0
558,684,2,1288,0,579,0.45,0.0,1,998,0.775,0.5,1,1120,0.87,0.5,1,1251,0.971,0.5,2,1280,0.994,1.0,2,1284,0.997,1.0,2,1287,0.999,1.0
559,685,1,1289,0,579,0.449,0.0,1,999,0.775,1.0,1,1121,0.87,1.0,1,1252,0.971,1.0,1,1281,0.994,1.0,1,1285,0.997,1.0,1,1288,0.999,1.0
560,686,1,1290,0,579,0.449,0.0,0,999,0.774,0.0,0,1121,0.869,0.0,1,1253,0.971,1.0,1,1282,0.994,1.0,1,1286,0.997,1.0,1,1289,0.999,1.0
561,687,1,1291,0,579,0.448,0.0,1,1000,0.775,1.0,1,1122,0.869,1.0,1,1254,0.971,1.0,1,1283,0.994,1.0,1,1287,0.997,1.0,1,1290,0.999,1.0
562,688,2,1293,0,579,0.448,0.0,0,1000,0.773,0.0,2,1124,0.869,1.0,2,1256,0.971,1.0,2,1285,0.994,1.0,2,1289,0.997,1.0,2,1292,0.999,1.0
563,689,1,1294,0,579,0.447,0.0,0,1000,0.773,0.0,0,1124,0.869,0.0,1,1257,0.971,1.0,1,1286,0.994,1.0,1,1290,0.997,1.0,1,1293,0.999,1.0
564,690,2,1296,0,579,0.447,0.0,0,1000,0.772,0.0,0,1124,0.867,0.0,2,1259,0.971,1.0,2,1288,0.994,1.0,2,1292,0.997,1.0,2,1295,0.999,1.0
565,691,3,1299,2,581,0.447,0.667,2,1002,0.771,0.667,2,1126,0.867,0.667,3,1262,0.972,1.0,3,1291,0.994,1.0,3,1295,0.997,1.0,3,1298,0.999,1.0
566,692,2,1301,0,581,0.447,0.0,2,1004,0.772,1.0,2,1128,0.867,1.0,2,1264,0.972,1.0,2,1293,0.994,1.0,2,1297,0.997,1.0,2,1300,0.999,1.0
567,693,2,1303,1,582,0.447,0.5,2,1006,0.772,1.0,2,1130,0.867,1.0,2,1266,0.972,1.0,2,1295,0.994,1.0,2,1299,0.997,1.0,2,1302,0.999,1.0
568,694,2,1305,1,583,0.447,0.5,2,1008,0.772,1.0,2,1132,0.867,1.0,2,1268,0.972,1.0,2,1297,0.994,1.0,2,1301,0.997,1.0,2,1304,0.999,1.0
569,696,2,1307,0,583,0.446,0.0,1,1009,0.772,0.5,2,1134,0.868,1.0,2,1270,0.972,1.0,2,1299,0.994,1.0,2,1303,0.997,1.0,2,1306,0.999,1.0
570,697,1,1308,0,583,0.446,0.0,0,1009,0.771,0.0,0,1134,0.867,0.0,1,1271,0.972,1.0,1,1300,0.994,1.0,1,1304,0.997,1.0,1,1307,0.999,1.0
571,698,2,1310,0,583,0.445,0.0,1,1010,0.771,0.5,1,1135,0.866,0.5,2,1273,0.972,1.0,2,1302,0.994,1.0,2,1306,0.997,1.0,2,1309,0.999,1.0
572,699,1,1311,0,583,0.445,0.0,1,1011,0.771,1.0,1,1136,0.867,1.0,1,1274,0.972,1.0,1,1303,0.994,1.0,1,1307,0.997,1.0,1,1310,0.999,1.0
573,701,2,1313,0,583,0.444,0.0,1,1012,0.771,0.5,2,1138,0.867,1.0,2,1276,0.972,1.0,2,1305,0.994,1.0,2,1309,0.997,1.0,2,1312,0.999,1.0
574,702,2,1315,0,583,0.443,0.0,1,1013,0.77,0.5,1,1139,0.866,0.5,2,1278,0.972,1.0,2,1307,0.994,1.0,2,1311,0.997,1.0,2,1314,0.999,1.0
575,703,3,1318,0,583,0.442,0.0,0,1013,0.769,0.0,0,1139,0.864,0.0,1,1279,0.97,0.333,2,1309,0.993,0.667,3,1314,0.997,1.0,3,1317,0.999,1.0
576,705,3,1321,0,583,0.441,0.0,2,1015,0.768,0.667,3,1142,0.864,1.0,3,1282,0.97,1.0,3,1312,0.993,1.0,3,1317,0.997,1.0,3,1320,0.999,1.0
577,707,1,1322,1,584,0.442,1.0,1,1016,0.769,1.0,1,1143,0.865,1.0,1,1283,0.97,1.0,1,1313,0.993,1.0,1,1318,0.997,1.0,1,1321,0.999,1.0
578,708,2,1324,1,585,0.442,0.5,1,1017,0.768,0.5,1,1144,0.864,0.5,2,1285,0.971,1.0,2,1315,0.993,1.0,2,1320,0.997,1.0,2,1323,0.999,1.0
579,709,2,1326,1,586,0.442,0.5,2,1019,0.768,1.0,2,1146,0.864,1.0,2,1287,0.971,1.0,2,1317,0.993,1.0,2,1322,0.997,1.0,2,1325,0.999,1.0
580,710,2,1328,0,586,0.441,0.0,0,1019,0.767,0.0,0,1146,0.863,0.0,0,1287,0.969,0.0,1,1318,0.992,0.5,1,1323,0.996,0.5,1,1326,0.998,0.5
581,712,3,1331,0,586,0.44,0.0,1,1020,0.766,0.333,2,1148,0.863,0.667,2,1289,0.968,0.667,2,1320,0.992,0.667,2,1325,0.995,0.667,3,1329,0.998,1.0
582,715,1,1332,1,587,0.441,1.0,1,1021,0.767,1.0,1,1149,0.863,1.0,1,1290,0.968,1.0,1,1321,0.992,1.0,1,1326,0.995,1.0,1,1330,0.998,1.0
583,716,1,1333,0,587,0.44,0.0,1,1022,0.767,1.0,1,1150,0.863,1.0,1,1291,0.968,1.0,1,1322,0.992,1.0,1,1327,0.995,1.0,1,1331,0.998,1.0
584,717,1,1334,0,587,0.44,0.0,1,1023,0.767,1.0,1,1151,0.863,1.0,1,1292,0.969,1.0,1,1323,0.992,1.0,1,1328,0.996,1.0,1,1332,0.999,1.0
585,718,2,1336,1,588,0.44,0.5,1,1024,0.766,0.5,1,1152,0.862,0.5,2,1294,0.969,1.0,2,1325,0.992,1.0,2,1330,0.996,1.0,2,1334,0.999,1.0
586,720,1,1337,0,588,0.44,0.0,1,1025,0.767,1.0,1,1153,0.862,1.0,1,1295,0.969,1.0,1,1326,0.992,1.0,1,1331,0.996,1.0,1,1335,0.999,1.0
587,721,1,1338,0,588,0.439,0.0,1,1026,0.767,1.0,1,1154,0.862,1.0,1,1296,0.969,1.0,1,1327,0.992,1.0,1,1332,0.996,1.0,1,1336,0.999,1.0
588,722,2,1340,1,589,0.44,0.5,2,1028,0.767,1.0,2,1156,0.863,1.0,2,1298,0.969,1.0,2,1329,0.992,1.0,2,1334,0.996,1.0,2,1338,0.999,1.0
589,725,1,1341,0,589,0.439,0.0,1,1029,0.767,1.0,1,1157,0.863,1.0,1,1299,0.969,1.0,1,1330,0.992,1.0,1,1335,0.996,1.0,1,1339,0.999,1.0
590,727,1,1342,0,589,0.439,0.0,1,1030,0.768,1.0,1,1158,0.863,1.0,1,1300,0.969,1.0,1,1331,0.992,1.0,1,1336,0.996,1.0,1,1340,0.999,1.0
591,728,2,1344,0,589,0.438,0.0,1,1031,0.767,0.5,1,1159,0.862,0.5,2,1302,0.969,1.0,2,1333,0.992,1.0,2,1338,0.996,1.0,2,1342,0.999,1.0
592,729,1,1345,0,589,0.438,0.0,0,1031,0.767,0.0,1,1160,0.862,1.0,1,1303,0.969,1.0,1,1334,0.992,1.0,1,1339,0.996,1.0,1,1343,0.999,1.0
593,730,3,1348,0,589,0.437,0.0,2,1033,0.766,0.667,2,1162,0.862,0.667,2,1305,0.968,0.667,2,1336,0.991,0.667,3,1342,0.996,1.0,3,1346,0.999,1.0
594,731,2,1350,0,589,0.436,0.0,0,1033,0.765,0.0,2,1164,0.862,1.0,2,1307,0.968,1.0,2,1338,0.991,1.0,2,1344,0.996,1.0,2,1348,0.999,1.0
595,732,1,1351,0,589,0.436,0.0,1,1034,0.765,1.0,1,1165,0.862,1.0,1,1308,0.968,1.0,1,1339,0.991,1.0,1,1345,0.996,1.0,1,1349,0.999,1.0
596,734,1,1352,0,589,0.436,0.0,1,1035,0.766,1.0,1,1166,0.862,1.0,1,1309,0.968,1.0,1,1340,0.991,1.0,1,1346,0.996,1.0,1,1350,0.999,1.0
597,738,1,1353,1,590,0.436,1.0,1,1036,0.766,1.0,1,1167,0.863,1.0,1,1310,0.968,1.0,1,1341,0.991,1.0,1,1347,0.996,1.0,1,1351,0.999,1.0
598,739,3,1356,1,591,0.436,0.333,1,1037,0.765,0.333,3,1170,0.863,1.0,3,1313,0.968,1.0,3,1344,0.991,1.0,3,1350,0.996,1.0,3,1354,0.999,1.0
599,740,1,1357,0,591,0.436,0.0,1,1038,0.765,1.0,1,1171,0.863,1.0,1,1314,0.968,1.0,1,1345,0.991,1.0,1,1351,0.996,1.0,1,1355,0.999,1.0
600,741,1,1358,0,591,0.435,0.0,0,1038,0.764,0.0,1,1172,0.863,1.0,1,1315,0.968,1.0,1,1346,0.991,1.0,1,1352,0.996,1.0,1,1356,0.999,1.0
601,742,1,1359,0,591,0.435,0.0,0,1038,0.764,0.0,0,1172,0.862,0.0,1,1316,0.968,1.0,1,1347,0.991,1.0,1,1353,0.996,1.0,1,1357,0.999,1.0
602,743,1,1360,0,591,0.435,0.0,1,1039,0.764,1.0,1,1173,0.862,1.0,1,1317,0.968,1.0,1,1348,0.991,1.0,1,1354,0.996,1.0,1,1358,0.999,1.0
603,744,3,1363,0,591,0.434,0.0,0,1039,0.762,0.0,1,1174,0.861,0.333,2,1319,0.968,0.667,3,1351,0.991,1.0,3,1357,0.996,1.0,3,1361,0.999,1.0
604,745,1,1364,0,591,0.433,0.0,1,1040,0.762,1.0,1,1175,0.861,1.0,1,1320,0.968,1.0,1,1352,0.991,1.0,1,1358,0.996,1.0,1,1362,0.999,1.0
605,747,1,1365,0,591,0.433,0.0,0,1040,0.762,0.0,0,1175,0.861,0.0,0,1320,0.967,0.0,1,1353,0.991,1.0,1,1359,0.996,1.0,1,1363,0.999,1.0
606,749,1,1366,0,591,0.433,0.0,0,1040,0.761,0.0,1,1176,0.861,1.0,1,1321,0.967,1.0,1,1354,0.991,1.0,1,1360,0.996,1.0,1,1364,0.999,1.0
607,750,1,1367,0,591,0.432,0.0,1,1041,0.762,1.0,1,1177,0.861,1.0,1,1322,0.967,1.0,1,1355,0.991,1.0,1,1361,0.996,1.0,1,1365,0.999,1.0
608,754,1,1368,0,591,0.432,0.0,0,1041,0.761,0.0,0,1177,0.86,0.0,1,1323,0.967,1.0,1,1356,0.991,1.0,1,1362,0.996,1.0,1,1366,0.999,1.0
609,758,1,1369,0,591,0.432,0.0,1,1042,0.761,1.0,1,1178,0.86,1.0,1,1324,0.967,1.0,1,1357,0.991,1.0,1,1363,0.996,1.0,1,1367,0.999,1.0
610,760,1,1370,0,591,0.431,0.0,0,1042,0.761,0.0,1,1179,0.861,1.0,1,1325,0.967,1.0,1,1358,0.991,1.0,1,1364,0.996,1.0,1,1368,0.999,1.0
611,761,1,1371,0,591,0.431,0.0,0,1042,0.76,0.0,1,1180,0.861,1.0,1,1326,0.967,1.0,1,1359,0.991,1.0,1,1365,0.996,1.0,1,1369,0.999,1.0
612,764,2,1373,0,591,0.43,0.0,0,1042,0.759,0.0,1,1181,0.86,0.5,1,1327,0.966,0.5,2,1361,0.991,1.0,2,1367,0.996,1.0,2,1371,0.999,1.0
613,766,2,1375,1,592,0.431,0.5,1,1043,0.759,0.5,1,1182,0.86,0.5,2,1329,0.967,1.0,2,1363,0.991,1.0,2,1369,0.996,1.0,2,1373,0.999,1.0
614,767,1,1376,1,593,0.431,1.0,1,1044,0.759,1.0,1,1183,0.86,1.0,1,1330,0.967,1.0,1,1364,0.991,1.0,1,1370,0.996,1.0,1,1374,0.999,1.0
615,769,2,1378,1,594,0.431,0.5,1,1045,0.758,0.5,1,1184,0.859,0.5,1,1331,0.966,0.5,2,1366,0.991,1.0,2,1372,0.996,1.0,2,1376,0.999,1.0
616,772,1,1379,0,594,0.431,0.0,0,1045,0.758,0.0,0,1184,0.859,0.0,0,1331,0.965,0.0,0,1366,0.991,0.0,0,1372,0.995,0.0,1,1377,0.999,1.0
617,773,3,1382,0,594,0.43,0.0,1,1046,0.757,0.333,3,1187,0.859,1.0,3,1334,0.965,1.0,3,1369,0.991,1.0,3,1375,0.995,1.0,3,1380,0.999,1.0
618,778,1,1383,0,594,0.43,0.0,0,1046,0.756,0.0,1,1188,0.859,1.0,1,1335,0.965,1.0,1,1370,0.991,1.0,1,1376,0.995,1.0,1,1381,0.999,1.0
619,781,1,1384,0,594,0.429,0.0,1,1047,0.757,1.0,1,1189,0.859,1.0,1,1336,0.965,1.0,1,1371,0.991,1.0,1,1377,0.995,1.0,1,1382,0.999,1.0
620,782,1,1385,0,594,0.429,0.0,0,1047,0.756,0.0,1,1190,0.859,1.0,1,1337,0.965,1.0,1,1372,0.991,1.0,1,1378,0.995,1.0,1,1383,0.999,1.0
621,783,1,1386,0,594,0.429,0.0,1,1048,0.756,1.0,1,1191,0.859,1.0,1,1338,0.965,1.0,1,1373,0.991,1.0,1,1379,0.995,1.0,1,1384,0.999,1.0
622,789,1,1387,0,594,0.428,0.0,0,1048,0.756,0.0,1,1192,0.859,1.0,1,1339,0.965,1.0,1,1374,0.991,1.0,1,1380,0.995,1.0,1,1385,0.999,1.0
623,790,1,1388,0,594,0.428,0.0,0,1048,0.755,0.0,0,1192,0.859,0.0,1,1340,0.965,1.0,1,1375,0.991,1.0,1,1381,0.995,1.0,1,1386,0.999,1.0
624,791,2,1390,0,594,0.427,0.0,1,1049,0.755,0.5,2,1194,0.859,1.0,2,1342,0.965,1.0,2,1377,0.991,1.0,2,1383,0.995,1.0,2,1388,0.999,1.0
625,795,1,1391,0,594,0.427,0.0,0,1049,0.754,0.0,0,1194,0.858,0.0,1,1343,0.965,1.0,1,1378,0.991,1.0,1,1384,0.995,1.0,1,1389,0.999,1.0
626,797,2,1393,0,594,0.426,0.0,0,1049,0.753,0.0,0,1194,0.857,0.0,0,1343,0.964,0.0,1,1379,0.99,0.5,2,1386,0.995,1.0,2,1391,0.999,1.0
627,798,3,1396,0,594,0.426,0.0,0,1049,0.751,0.0,0,1194,0.855,0.0,2,1345,0.963,0.667,3,1382,0.99,1.0,3,1389,0.995,1.0,3,1394,0.999,1.0
628,799,2,1398,0,594,0.425,0.0,1,1050,0.751,0.5,2,1196,0.856,1.0,2,1347,0.964,1.0,2,1384,0.99,1.0,2,1391,0.995,1.0,2,1396,0.999,1.0
629,800,1,1399,0,594,0.425,0.0,0,1050,0.751,0.0,0,1196,0.855,0.0,1,1348,0.964,1.0,1,1385,0.99,1.0,1,1392,0.995,1.0,1,1397,0.999,1.0
630,801,1,1400,0,594,0.424,0.0,0,1050,0.75,0.0,1,1197,0.855,1.0,1,1349,0.964,1.0,1,1386,0.99,1.0,1,1393,0.995,1.0,1,1398,0.999,1.0
631,804,1,1401,0,594,0.424,0.0,0,1050,0.749,0.0,0,1197,0.854,0.0,1,1350,0.964,1.0,1,1387,0.99,1.0,1,1394,0.995,1.0,1,1399,0.999,1.0
632,806,1,1402,0,594,0.424,0.0,1,1051,0.75,1.0,1,1198,0.854,1.0,1,1351,0.964,1.0,1,1388,0.99,1.0,1,1395,0.995,1.0,1,1400,0.999,1.0
633,807,2,1404,0,594,0.423,0.0,1,1052,0.749,0.5,2,1200,0.855,1.0,2,1353,0.964,1.0,2,1390,0.99,1.0,2,1397,0.995,1.0,2,1402,0.999,1.0
634,810,1,1405,0,594,0.423,0.0,0,1052,0.749,0.0,0,1200,0.854,0.0,0,1353,0.963,0.0,1,1391,0.99,1.0,1,1398,0.995,1.0,1,1403,0.999,1.0
635,812,1,1406,0,594,0.422,0.0,0,1052,0.748,0.0,1,1201,0.854,1.0,1,1354,0.963,1.0,1,1392,0.99,1.0,1,1399,0.995,1.0,1,1404,0.999,1.0
636,813,2,1408,0,594,0.422,0.0,1,1053,0.748,0.5,1,1202,0.854,0.5,2,1356,0.963,1.0,2,1394,0.99,1.0,2,1401,0.995,1.0,2,1406,0.999,1.0
637,814,2,1410,0,594,0.421,0.0,2,1055,0.748,1.0,2,1204,0.854,1.0,2,1358,0.963,1.0,2,1396,0.99,1.0,2,1403,0.995,1.0,2,1408,0.999,1.0
638,815,1,1411,0,594,0.421,0.0,0,1055,0.748,0.0,0,1204,0.853,0.0,1,1359,0.963,1.0,1,1397,0.99,1.0,1,1404,0.995,1.0,1,1409,0.999,1.0
639,817,1,1412,0,594,0.421,0.0,0,1055,0.747,0.0,0,1204,0.853,0.0,1,1360,0.963,1.0,1,1398,0.99,1.0,1,1405,0.995,1.0,1,1410,0.999,1.0
640,820,1,1413,1,595,0.421,1.0,1,1056,0.747,1.0,1,1205,0.853,1.0,1,1361,0.963,1.0,1,1399,0.99,1.0,1,1406,0.995,1.0,1,1411,0.999,1.0
641,822,1,1414,0,595,0.421,0.0,1,1057,0.748,1.0,1,1206,0.853,1.0,1,1362,0.963,1.0,1,1400,0.99,1.0,1,1407,0.995,1.0,1,1412,0.999,1.0
642,827,2,1416,0,595,0.42,0.0,0,1057,0.746,0.0,1,1207,0.852,0.5,1,1363,0.963,0.5,1,1401,0.989,0.5,1,1408,0.994,0.5,2,1414,0.999,1.0
643,828,1,1417,0,595,0.42,0.0,0,1057,0.746,0.0,0,1207,0.852,0.0,1,1364,0.963,1.0,1,1402,0.989,1.0,1,1409,0.994,1.0,1,1415,0.999,1.0
644,832,1,1418,0,595,0.42,0.0,1,1058,0.746,1.0,1,1208,0.852,1.0,1,1365,0.963,1.0,1,1403,0.989,1.0,1,1410,0.994,1.0,1,1416,0.999,1.0
645,833,2,1420,0,595,0.419,0.0,0,1058,0.745,0.0,1,1209,0.851,0.5,2,1367,0.963,1.0,2,1405,0.989,1.0,2,1412,0.994,1.0,2,1418,0.999,1.0
646,834,1,1421,1,596,0.419,1.0,1,1059,0.745,1.0,1,1210,0.852,1.0,1,1368,0.963,1.0,1,1406,0.989,1.0,1,1413,0.994,1.0,1,1419,0.999,1.0
647,835,3,1424,2,598,0.42,0.667,2,1061,0.745,0.667,2,1212,0.851,0.667,3,1371,0.963,1.0,3,1409,0.989,1.0,3,1416,0.994,1.0,3,1422,0.999,1.0
648,836,3,1427,0,598,0.419,0.0,1,1062,0.744,0.333,1,1213,0.85,0.333,2,1373,0.962,0.667,3,1412,0.989,1.0,3,1419,0.994,1.0,3,1425,0.999,1.0
649,838,1,1428,0,598,0.419,0.0,0,1062,0.744,0.0,0,1213,0.849,0.0,1,1374,0.962,1.0,1,1413,0.989,1.0,1,1420,0.994,1.0,1,1426,0.999,1.0
650,839,2,1430,0,598,0.418,0.0,1,1063,0.743,0.5,1,1214,0.849,0.5,2,1376,0.962,1.0,2,1415,0.99,1.0,2,1422,0.994,1.0,2,1428,0.999,1.0
651,842,2,1432,0,598,0.418,0.0,1,1064,0.743,0.5,1,1215,0.848,0.5,1,1377,0.962,0.5,1,1416,0.989,0.5,1,1423,0.994,0.5,2,1430,0.999,1.0
652,845,1,1433,1,599,0.418,1.0,1,1065,0.743,1.0,1,1216,0.849,1.0,1,1378,0.962,1.0,1,1417,0.989,1.0,1,1424,0.994,1.0,1,1431,0.999,1.0
653,847,1,1434,0,599,0.418,0.0,0,1065,0.743,0.0,0,1216,0.848,0.0,1,1379,0.962,1.0,1,1418,0.989,1.0,1,1425,0.994,1.0,1,1432,0.999,1.0
654,848,1,1435,0,599,0.417,0.0,1,1066,0.743,1.0,1,1217,0.848,1.0,1,1380,0.962,1.0,1,1419,0.989,1.0,1,1426,0.994,1.0,1,1433,0.999,1.0
655,850,1,1436,0,599,0.417,0.0,0,1066,0.742,0.0,1,1218,0.848,1.0,1,1381,0.962,1.0,1,1420,0.989,1.0,1,1427,0.994,1.0,1,1434,0.999,1.0
656,853,1,1437,1,600,0.418,1.0,1,1067,0.743,1.0,1,1219,0.848,1.0,1,1382,0.962,1.0,1,1421,0.989,1.0,1,1428,0.994,1.0,1,1435,0.999,1.0
657,854,2,1439,1,601,0.418,0.5,1,1068,0.742,0.5,1,1220,0.848,0.5,2,1384,0.962,1.0,2,1423,0.989,1.0,2,1430,0.994,1.0,2,1437,0.999,1.0
658,856,2,1441,0,601,0.417,0.0,0,1068,0.741,0.0,1,1221,0.847,0.5,2,1386,0.962,1.0,2,1425,0.989,1.0,2,1432,0.994,1.0,2,1439,0.999,1.0
659,858,2,1443,0,601,0.416,0.0,1,1069,0.741,0.5,1,1222,0.847,0.5,2,1388,0.962,1.0,2,1427,0.989,1.0,2,1434,0.994,1.0,2,1441,0.999,1.0
660,861,1,1444,0,601,0.416,0.0,1,1070,0.741,1.0,1,1223,0.847,1.0,1,1389,0.962,1.0,1,1428,0.989,1.0,1,1435,0.994,1.0,1,1442,0.999,1.0
661,863,1,1445,0,601,0.416,0.0,1,1071,0.741,1.0,1,1224,0.847,1.0,1,1390,0.962,1.0,1,1429,0.989,1.0,1,1436,0.994,1.0,1,1443,0.999,1.0
662,864,1,1446,0,601,0.416,0.0,0,1071,0.741,0.0,0,1224,0.846,0.0,0,1390,0.961,0.0,1,1430,0.989,1.0,1,1437,0.994,1.0,1,1444,0.999,1.0
663,865,2,1448,1,602,0.416,0.5,1,1072,0.74,0.5,1,1225,0.846,0.5,2,1392,0.961,1.0,2,1432,0.989,1.0,2,1439,0.994,1.0,2,1446,0.999,1.0
664,867,2,1450,0,602,0.415,0.0,0,1072,0.739,0.0,1,1226,0.846,0.5,1,1393,0.961,0.5,2,1434,0.989,1.0,2,1441,0.994,1.0,2,1448,0.999,1.0
665,868,4,1454,1,603,0.415,0.25,1,1073,0.738,0.25,2,1228,0.845,0.5,4,1397,0.961,1.0,4,1438,0.989,1.0,4,1445,0.994,1.0,4,1452,0.999,1.0
666,869,1,1455,0,603,0.414,0.0,0,1073,0.737,0.0,1,1229,0.845,1.0,1,1398,0.961,1.0,1,1439,0.989,1.0,1,1446,0.994,1.0,1,1453,0.999,1.0
667,870,1,1456,0,603,0.414,0.0,1,1074,0.738,1.0,1,1230,0.845,1.0,1,1399,0.961,1.0,1,1440,0.989,1.0,1,1447,0.994,1.0,1,1454,0.999,1.0
668,874,1,1457,0,603,0.414,0.0,1,1075,0.738,1.0,1,1231,0.845,1.0,1,1400,0.961,1.0,1,1441,0.989,1.0,1,1448,0.994,1.0,1,1455,0.999,1.0
669,875,1,1458,0,603,0.414,0.0,1,1076,0.738,1.0,1,1232,0.845,1.0,1,1401,0.961,1.0,1,1442,0.989,1.0,1,1449,0.994,1.0,1,1456,0.999,1.0
670,879,1,1459,0,603,0.413,0.0,0,1076,0.737,0.0,1,1233,0.845,1.0,1,1402,0.961,1.0,1,1443,0.989,1.0,1,1450,0.994,1.0,1,1457,0.999,1.0
671,880,1,1460,0,603,0.413,0.0,0,1076,0.737,0.0,0,1233,0.845,0.0,1,1403,0.961,1.0,1,1444,0.989,1.0,1,1451,0.994,1.0,1,1458,0.999,1.0
672,881,1,1461,0,603,0.413,0.0,0,1076,0.736,0.0,0,1233,0.844,0.0,0,1403,0.96,0.0,0,1444,0.988,0.0,1,1452,0.994,1.0,1,1459,0.999,1.0
673,883,1,1462,0,603,0.412,0.0,0,1076,0.736,0.0,0,1233,0.843,0.0,0,1403,0.96,0.0,0,1444,0.988,0.0,1,1453,0.994,1.0,1,1460,0.999,1.0
674,884,1,1463,0,603,0.412,0.0,1,1077,0.736,1.0,1,1234,0.843,1.0,1,1404,0.96,1.0,1,1445,0.988,1.0,1,1454,0.994,1.0,1,1461,0.999,1.0
675,885,1,1464,0,603,0.412,0.0,0,1077,0.736,0.0,0,1234,0.843,0.0,0,1404,0.959,0.0,1,1446,0.988,1.0,1,1455,0.994,1.0,1,1462,0.999,1.0
676,886,2,1466,0,603,0.411,0.0,0,1077,0.735,0.0,0,1234,0.842,0.0,0,1404,0.958,0.0,2,1448,0.988,1.0,2,1457,0.994,1.0,2,1464,0.999,1.0
677,889,1,1467,0,603,0.411,0.0,0,1077,0.734,0.0,0,1234,0.841,0.0,0,1404,0.957,0.0,0,1448,0.987,0.0,0,1457,0.993,0.0,1,1465,0.999,1.0
678,891,1,1468,0,603,0.411,0.0,1,1078,0.734,1.0,1,1235,0.841,1.0,1,1405,0.957,1.0,1,1449,0.987,1.0,1,1458,0.993,1.0,1,1466,0.999,1.0
679,894,1,1469,0,603,0.41,0.0,0,1078,0.734,0.0,0,1235,0.841,0.0,0,1405,0.956,0.0,0,1449,0.986,0.0,0,1458,0.993,0.0,0,1466,0.998,0.0
680,897,1,1470,0,603,0.41,0.0,1,1079,0.734,1.0,1,1236,0.841,1.0,1,1406,0.956,1.0,1,1450,0.986,1.0,1,1459,0.993,1.0,1,1467,0.998,1.0
681,899,1,1471,0,603,0.41,0.0,0,1079,0.734,0.0,1,1237,0.841,1.0,1,1407,0.956,1.0,1,1451,0.986,1.0,1,1460,0.993,1.0,1,1468,0.998,1.0
682,900,1,1472,0,603,0.41,0.0,0,1079,0.733,0.0,0,1237,0.84,0.0,0,1407,0.956,0.0,1,1452,0.986,1.0,1,1461,0.993,1.0,1,1469,0.998,1.0
683,902,2,1474,0,603,0.409,0.0,1,1080,0.733,0.5,2,1239,0.841,1.0,2,1409,0.956,1.0,2,1454,0.986,1.0,2,1463,0.993,1.0,2,1471,0.998,1.0
684,905,1,1475,0,603,0.409,0.0,1,1081,0.733,1.0,1,1240,0.841,1.0,1,1410,0.956,1.0,1,1455,0.986,1.0,1,1464,0.993,1.0,1,1472,0.998,1.0
685,906,1,1476,0,603,0.409,0.0,0,1081,0.732,0.0,1,1241,0.841,1.0,1,1411,0.956,1.0,1,1456,0.986,1.0,1,1465,0.993,1.0,1,1473,0.998,1.0
686,908,2,1478,1,604,0.409,0.5,1,1082,0.732,0.5,2,1243,0.841,1.0,2,1413,0.956,1.0,2,1458,0.986,1.0,2,1467,0.993,1.0,2,1475,0.998,1.0
687,910,1,1479,1,605,0.409,1.0,1,1083,0.732,1.0,1,1244,0.841,1.0,1,1414,0.956,1.0,1,1459,0.986,1.0,1,1468,0.993,1.0,1,1476,0.998,1.0
688,911,1,1480,0,605,0.409,0.0,0,1083,0.732,0.0,0,1244,0.841,0.0,1,1415,0.956,1.0,1,1460,0.986,1.0,1,1469,0.993,1.0,1,1477,0.998,1.0
689,913,1,1481,0,605,0.409,0.0,0,1083,0.731,0.0,1,1245,0.841,1.0,1,1416,0.956,1.0,1,1461,0.986,1.0,1,1470,0.993,1.0,1,1478,0.998,1.0
690,916,1,1482,1,606,0.409,1.0,1,1084,0.731,1.0,1,1246,0.841,1.0,1,1417,0.956,1.0,1,1462,0.987,1.0,1,1471,0.993,1.0,1,1479,0.998,1.0
691,917,1,1483,0,606,0.409,0.0,0,1084,0.731,0.0,1,1247,0.841,1.0,1,1418,0.956,1.0,1,1463,0.987,1.0,1,1472,0.993,1.0,1,1480,0.998,1.0
692,920,3,1486,0,606,0.408,0.0,1,1085,0.73,0.333,2,1249,0.841,0.667,2,1420,0.956,0.667,3,1466,0.987,1.0,3,1475,0.993,1.0,3,1483,0.998,1.0
693,921,1,1487,0,606,0.408,0.0,1,1086,0.73,1.0,1,1250,0.841,1.0,1,1421,0.956,1.0,1,1467,0.987,1.0,1,1476,0.993,1.0,1,1484,0.998,1.0
694,925,1,1488,0,606,0.407,0.0,0,1086,0.73,0.0,0,1250,0.84,0.0,1,1422,0.956,1.0,1,1468,0.987,1.0,1,1477,0.993,1.0,1,1485,0.998,1.0
695,928,1,1489,0,606,0.407,0.0,0,1086,0.729,0.0,0,1250,0.839,0.0,0,1422,0.955,0.0,1,1469,0.987,1.0,1,1478,0.993,1.0,1,1486,0.998,1.0
696,929,1,1490,0,606,0.407,0.0,0,1086,0.729,0.0,0,1250,0.839,0.0,0,1422,0.954,0.0,1,1470,0.987,1.0,1,1479,0.993,1.0,1,1487,0.998,1.0
697,931,2,1492,0,606,0.406,0.0,0,1086,0.728,0.0,1,1251,0.838,0.5,1,1423,0.954,0.5,2,1472,0.987,1.0,2,1481,0.993,1.0,2,1489,0.998,1.0
698,932,1,1493,0,606,0.406,0.0,1,1087,0.728,1.0,1,1252,0.839,1.0,1,1424,0.954,1.0,1,1473,0.987,1.0,1,1482,0.993,1.0,1,1490,0.998,1.0
699,933,2,1495,0,606,0.405,0.0,0,1087,0.727,0.0,0,1252,0.837,0.0,1,1425,0.953,0.5,1,1474,0.986,0.5,2,1484,0.993,1.0,2,1492,0.998,1.0
700,934,2,1497,0,606,0.405,0.0,1,1088,0.727,0.5,2,1254,0.838,1.0,2,1427,0.953,1.0,2,1476,0.986,1.0,2,1486,0.993,1.0,2,1494,0.998,1.0
701,935,1,1498,0,606,0.405,0.0,0,1088,0.726,0.0,0,1254,0.837,0.0,1,1428,0.953,1.0,1,1477,0.986,1.0,1,1487,0.993,1.0,1,1495,0.998,1.0
702,936,1,1499,0,606,0.404,0.0,0,1088,0.726,0.0,1,1255,0.837,1.0,1,1429,0.953,1.0,1,1478,0.986,1.0,1,1488,0.993,1.0,1,1496,0.998,1.0
703,937,1,1500,0,606,0.404,0.0,1,1089,0.726,1.0,1,1256,0.837,1.0,1,1430,0.953,1.0,1,1479,0.986,1.0,1,1489,0.993,1.0,1,1497,0.998,1.0
704,938,1,1501,0,606,0.404,0.0,0,1089,0.726,0.0,0,1256,0.837,0.0,0,1430,0.953,0.0,0,1479,0.985,0.0,1,1490,0.993,1.0,1,1498,0.998,1.0
705,941,1,1502,0,606,0.403,0.0,0,1089,0.725,0.0,1,1257,0.837,1.0,1,1431,0.953,1.0,1,1480,0.985,1.0,1,1491,0.993,1.0,1,1499,0.998,1.0
706,943,1,1503,0,606,0.403,0.0,1,1090,0.725,1.0,1,1258,0.837,1.0,1,1432,0.953,1.0,1,1481,0.985,1.0,1,1492,0.993,1.0,1,1500,0.998,1.0
707,944,1,1504,0,606,0.403,0.0,0,1090,0.725,0.0,0,1258,0.836,0.0,0,1432,0.952,0.0,1,1482,0.985,1.0,1,1493,0.993,1.0,1,1501,0.998,1.0
708,946,2,1506,0,606,0.402,0.0,0,1090,0.724,0.0,1,1259,0.836,0.5,1,1433,0.952,0.5,2,1484,0.985,1.0,2,1495,0.993,1.0,2,1503,0.998,1.0
709,947,2,1508,0,606,0.402,0.0,0,1090,0.723,0.0,1,1260,0.836,0.5,1,1434,0.951,0.5,2,1486,0.985,1.0,2,1497,0.993,1.0,2,1505,0.998,1.0
710,955,2,1510,0,606,0.401,0.0,0,1090,0.722,0.0,1,1261,0.835,0.5,1,1435,0.95,0.5,2,1488,0.985,1.0,2,1499,0.993,1.0,2,1507,0.998,1.0
711,957,1,1511,1,607,0.402,1.0,1,1091,0.722,1.0,1,1262,0.835,1.0,1,1436,0.95,1.0,1,1489,0.985,1.0,1,1500,0.993,1.0,1,1508,0.998,1.0
712,959,1,1512,0,607,0.401,0.0,1,1092,0.722,1.0,1,1263,0.835,1.0,1,1437,0.95,1.0,1,1490,0.985,1.0,1,1501,0.993,1.0,1,1509,0.998,1.0
713,961,1,1513,0,607,0.401,0.0,0,1092,0.722,0.0,0,1263,0.835,0.0,0,1437,0.95,0.0,1,1491,0.985,1.0,1,1502,0.993,1.0,1,1510,0.998,1.0
714,962,1,1514,0,607,0.401,0.0,0,1092,0.721,0.0,1,1264,0.835,1.0,1,1438,0.95,1.0,1,1492,0.985,1.0,1,1503,0.993,1.0,1,1511,0.998,1.0
715,967,1,1515,0,607,0.401,0.0,0,1092,0.721,0.0,0,1264,0.834,0.0,0,1438,0.949,0.0,1,1493,0.985,1.0,1,1504,0.993,1.0,1,1512,0.998,1.0
716,969,1,1516,0,607,0.4,0.0,1,1093,0.721,1.0,1,1265,0.834,1.0,1,1439,0.949,1.0,1,1494,0.985,1.0,1,1505,0.993,1.0,1,1513,0.998,1.0
717,971,1,1517,0,607,0.4,0.0,1,1094,0.721,1.0,1,1266,0.835,1.0,1,1440,0.949,1.0,1,1495,0.985,1.0,1,1506,0.993,1.0,1,1514,0.998,1.0
718,980,2,1519,0,607,0.4,0.0,0,1094,0.72,0.0,0,1266,0.833,0.0,1,1441,0.949,0.5,2,1497,0.986,1.0,2,1508,0.993,1.0,2,1516,0.998,1.0
719,983,1,1520,0,607,0.399,0.0,0,1094,0.72,0.0,0,1266,0.833,0.0,0,1441,0.948,0.0,1,1498,0.986,1.0,1,1509,0.993,1.0,1,1517,0.998,1.0
720,984,1,1521,0,607,0.399,0.0,0,1094,0.719,0.0,0,1266,0.832,0.0,1,1442,0.948,1.0,1,1499,0.986,1.0,1,1510,0.993,1.0,1,1518,0.998,1.0
721,985,1,1522,0,607,0.399,0.0,0,1094,0.719,0.0,0,1266,0.832,0.0,1,1443,0.948,1.0,1,1500,0.986,1.0,1,1511,0.993,1.0,1,1519,0.998,1.0
722,986,2,1524,0,607,0.398,0.0,0,1094,0.718,0.0,1,1267,0.831,0.5,2,1445,0.948,1.0,2,1502,0.986,1.0,2,1513,0.993,1.0,2,1521,0.998,1.0
723,987,1,1525,0,607,0.398,0.0,1,1095,0.718,1.0,1,1268,0.831,1.0,1,1446,0.948,1.0,1,1503,0.986,1.0,1,1514,0.993,1.0,1,1522,0.998,1.0
724,988,1,1526,0,607,0.398,0.0,0,1095,0.718,0.0,0,1268,0.831,0.0,1,1447,0.948,1.0,1,1504,0.986,1.0,1,1515,0.993,1.0,1,1523,0.998,1.0
725,992,1,1527,0,607,0.398,0.0,0,1095,0.717,0.0,0,1268,0.83,0.0,1,1448,0.948,1.0,1,1505,0.986,1.0,1,1516,0.993,1.0,1,1524,0.998,1.0
726,993,1,1528,0,607,0.397,0.0,1,1096,0.717,1.0,1,1269,0.83,1.0,1,1449,0.948,1.0,1,1506,0.986,1.0,1,1517,0.993,1.0,1,1525,0.998,1.0
727,994,1,1529,0,607,0.397,0.0,1,1097,0.717,1.0,1,1270,0.831,1.0,1,1450,0.948,1.0,1,1507,0.986,1.0,1,1518,0.993,1.0,1,1526,0.998,1.0
728,996,1,1530,0,607,0.397,0.0,0,1097,0.717,0.0,1,1271,0.831,1.0,1,1451,0.948,1.0,1,1508,0.986,1.0,1,1519,0.993,1.0,1,1527,0.998,1.0
